ns:base.engineering.dike.body_of_water	/base/engineering/flooding_body_of_water/flood_defence_dikes
ns:aviation.airliner_accident.aircraft_type	/aviation/aircraft_model/accidents
ns:education.academic.advisors	/education/academic/advisees
ns:computer.web_browser.extensions	/computer/web_browser_extension/works_on_web_browser
ns:base.disaster2.wrecked_ship.shipwreck	/base/disaster2/shipwreck/ship
ns:base.morelaw.legal_system.type_of_legal_system	/base/morelaw/type_of_legal_system/legal_systems_of_this_type
ns:film.film.genre	/film/film_genre/films_in_this_genre
ns:organization.organization_partnership.members	/organization/organization/partnerships
ns:cvg.computer_videogame.platforms	/cvg/cvg_platform/games
ns:base.disaster2.pandemic.disease	/base/disaster2/infectious_disease/epidemics
ns:measurement_unit.current_unit.measurement_system	/measurement_unit/measurement_system/current_units
ns:location.country.form_of_government	/government/form_of_government/countries
ns:food.candy_bar.manufacturer	/food/candy_bar_manufacturer/candy_bars
ns:medicine.infectious_disease.infectious_agent_type	/medicine/type_of_infectious_agent/diseases
ns:government.legislative_committee.subcommittees	/government/legislative_committee/subcommittee_of
ns:base.pinball.pinball_machine.manufacturer	/base/pinball/pinball_machine_manufacturer/pinball_machines
ns:business.defunct_company.reason_for_ceasing_operations	/business/company_termination_type/companies
ns:base.collectiblecards.trading_card_company.set_printed	/base/collectiblecards/trading_card_set/company
ns:user.zsi_editorial.editorial.editor.comments	/user/zsi_editorial/editorial/comment/editor
ns:base.pinball.pinball_machine.designer	/base/pinball/pinball_machine_designer/machines_designed
ns:base.kwebbase.kwconnection.other	/base/kwebbase/kwtopic/connections_to
ns:digicams.digital_camera.camera_sensor_manufacturer	/digicams/camera_sensor_manufacturer/cameras
ns:base.mathematics1.mathematical_concept.generalizations	/base/mathematics1/mathematical_concept/specializations
ns:book.newspaper.circulation_areas	/periodicals/newspaper_circulation_area/newspapers
ns:spaceflight.bipropellant_rocket_engine.oxidizer	/spaceflight/rocket_engine_oxidizer/rocket_engines
ns:base.webvideo.internet_video.director	/base/webvideo/internet_video_director/videos_directed
ns:base.locations.counties_parishes_and_boroughs.country	/base/locations/countries/counties_within
ns:internet.website.owner	/internet/website_owner/websites_owned
ns:broadcast.content.genre	/broadcast/genre/content
ns:base.jewlib.judaica_owner.research_collections	/base/jewlib/research_collection/collection_held_by
ns:film.film.subjects	/film/film_subject/films
ns:base.fairytales.fairy_tale.author	/base/fairytales/fairy_tale_author/fairy_tale_written
ns:sports.golf_facility.courses	/sports/golf_course/facility
ns:religion.religion.beliefs	/religion/belief/belief_of
ns:user.lindenb.default_domain.teacher.student	/user/lindenb/default_domain/student/teacher
ns:user.tsturge.language.letter.alphabet	/user/tsturge/language/alphabet/letter
ns:base.contractbridge.bridge_player.partners	/base/contractbridge/bridge_player_partnership/partner
ns:rail.locomotive_class.parent_class	/rail/locomotive_class/subclasses
ns:base.calendars.calendar.calendar_publisher	/base/calendars/calendars_published/calendars_published_by
ns:base.propositions.proposition.in_support_of	/base/propositions/proposition_issue/supported_by
ns:base.mystery.cryptozoologist.cryptid_s_investigated	/base/mystery/cryptid/people_who_investigated_this_cryptid
ns:film.film.film_production_design_by	/film/film_production_designer/films_production_designed
ns:base.dance.dance_form.parent_genre	/base/dance/dance_form/subgenre
ns:people.person.parents	/people/person/children
ns:user.arielb.israel.israeli_settlement.regional_council	/user/arielb/israel/regional_council/settlements
ns:base.typefaces.typeface.typeface_creator	/base/typefaces/typeface_creator/typefaces_created
ns:base.database.database.home_page1	/base/database/database_website/linked_database_s
ns:astronomy.meteor_shower.source_of_meteor_shower	/astronomy/comet/meteor_shower_spawned
ns:geography.geographical_feature_category.subcategories	/geography/geographical_feature_category/subcategory_of
ns:distilled_spirits.distillery.region	/distilled_spirits/spirit_producing_region/distilleries
ns:base.seafood.seafood.health_risk	/base/seafood/contaminant/contaminates
ns:base.argumentmaps.thing_of_disputed_value.praise	/base/argumentmaps/praise/thing_of_disputed_value
ns:religion.religion.practices	/religion/religious_practice/practice_of
ns:music.artist.label	/music/record_label/artist
ns:medicine.disease.risk_factors	/medicine/risk_factor/diseases
ns:cvg.computer_game_expansion.expansion_for	/cvg/computer_videogame/expansions
ns:base.motorcycle.motorcycle_series.model	/base/motorcycle/motorcycle_model/series
ns:base.skosbase.skos_concept.narrower	/base/skosbase/skos_concept/broader
ns:base.tallships.tall_ship_in_film.films	/base/tallships/film_with_tall_ships/tall_ships
ns:american_football.football_team.division	/american_football/football_division/teams
ns:base.column.column.author_of_column	/base/column/column_author_duration/column
ns:base.conservation.conservation_list.status_designation	/base/conservation/conservation_status_designation/defined_in
ns:religion.religious_leadership_jurisdiction.organisation	/religion/religious_organization/jurisdictions
ns:comic_books.comic_book_genre.comic_book_series_in_this_genre	/comic_books/comic_book_series/genre
ns:fictional_universe.fictional_organization.appears_in_universes	/fictional_universe/fictional_universe/organizations
ns:base.standardizedtesting.standardized_test.developer	/base/standardizedtesting/test_giving_organization/tests_being_developed
ns:base.technologyofdoing.knowledge_worker_trait.classification	/base/technologyofdoing/knowledge_worker_trait_class/strengths
ns:base.recordingstudios.studio_album.recorded_at	/base/recordingstudios/recording_studio/albums_recorded_here
ns:base.proposedprojects.proposed_project.proposer	/base/proposedprojects/project_proposer/projects
ns:book.book.characters	/book/book_character/appears_in_book
ns:people.family.members	/people/family_member/family
ns:media_common.literary_genre.books_in_this_genre	/book/book/genre
ns:zoos.zoo.category	/zoos/zoo_category/zoos
ns:base.nascar.nascar_racing_organization_owner.racing_organization_owned	/base/nascar/nascar_racing_organization/owners
ns:base.pokervariants.poker_variant.mechanics	/base/pokervariants/game_mechanic/used_in
ns:book.book_edition_series.series_editor	/book/series_editor/book_edition_series_edited
ns:user.robert.cool_tools.cool_tool.manufacturer_brand	/user/robert/cool_tools/manufacturer_brand/cool_tools_produced
ns:fictional_universe.fictional_character.powers_or_abilities	/fictional_universe/character_powers/characters_with_this_ability
ns:fictional_universe.fictional_character.organizations	/fictional_universe/fictional_organization/members
ns:base.associationfootball.soccer_squad.match	/base/associationfootball/soccer_match/team
ns:music.group_membership.group	/music/musical_group/member
ns:food.dish.cuisine	/dining/cuisine/dishes
ns:base.puzzles.puzzle.form	/base/puzzles/puzzle_form/instance
ns:base.activism.activism_issue.supporting_political_parties	/base/activism/political_party/supports_issues
ns:base.bowlgames.bowl_game.stadium	/base/bowlgames/bowl_game_stadium/bowl_game_hosted
ns:base.database.database.includes_database_s	/base/database/database/included_in_database_s
ns:medicine.cancer_center.constituents	/medicine/cancer_center_constituent/cancer_center
ns:user.agroschim.default_domain.literary_movement.important_writers	/user/agroschim/default_domain/notable_author_of_a_lit_movement/literary_movement
ns:base.bioventurist.technology_class.products_involving_this_technology	/base/bioventurist/product/technology_involved
ns:base.bigsky.region.site	/base/bigsky/site/region
ns:user.alexander.default_domain.human_sense.sense_organ	/user/alexander/default_domain/human_sense_organ/sense
ns:base.aliens.ufo_sighting.location	/base/aliens/ufo_sighting_location/ufo_sighting_s
ns:base.grecoromanmythology.mythological_entity.present_in	/base/grecoromanmythology/source/mythological_entities_depicted
ns:base.ikariam.ikariam_research.prerequisite	/base/ikariam/ikariam_research/researches_unlocked
ns:religion.religion.branched_into	/religion/religion/branched_from
ns:measurement_unit.substance_unit.measurement_system	/measurement_unit/measurement_system/substance_units
ns:film.performance.actor	/film/actor/film
ns:base.permaculture.permaculture_element.products	/base/permaculture/permaculture_element_product/produced_by
ns:comic_books.comic_book_issue.cover_inks	/comic_books/comic_book_inker/comic_covers_inked
ns:base.tallships.sail_training_vessel.sail_training_organization	/base/tallships/sail_training_organization/sail_training_vessels
ns:time.time_zone.locations_in_this_time_zone	/location/location/time_zones
ns:base.localfood.regional_food.originated_from	/base/localfood/regional_food_source/food
ns:base.textiles.textile.materials	/base/textiles/textile_fiber/textiles_sourced_from_this
ns:award.competition.instance_of_recurring_competition	/award/recurring_competition/individual_competitions
ns:base.litcentral.focal_location.land_manager	/base/litcentral/land_manager/focal_location_s_managed
ns:visual_art.artwork.media	/visual_art/visual_art_medium/artworks
ns:user.rca.default_domain.us_court_decision.court	/user/rca/default_domain/court/decision
ns:book.written_work.next_in_series	/book/written_work/previous_in_series
ns:book.literary_series.author_s	/book/author/series_written_or_contributed_to
ns:user.giladgoren.default_domain.telecom_equipment_type.sub_type	/user/giladgoren/default_domain/telecom_equipment_type/super_type
ns:medicine.medical_treatment.side_effects	/medicine/symptom/side_effect_of
ns:film.film.film_format	/film/film_format/film_format
ns:business.brand.parent_brand	/business/brand/includes_brands
ns:user.blackhound.hornblower_universe.book.characters_in_this_book	/user/blackhound/hornblower_universe/character/appears_in_books
ns:base.aareas.schema.administrative_area.subdividing_place	/base/aareas/schema/administrative_area/subdivides_place
ns:internet.website.parent_web_property	/internet/website/sub_web_properties
ns:base.politicalconventions.political_convention.vice_presidential_nominee	/base/politicalconventions/vice_presidential_nominee/convention_nominated_at
ns:base.argumentmaps.correlation.possibly_correlated_thing	/base/argumentmaps/possibly_correlated_thing/possible_correlations
ns:basketball.basketball_player.position_s	/basketball/basketball_position/players
ns:base.fight.protest.subject_of_protest	/base/fight/subject_of_protest/protests_about_this
ns:event.produced_event.produced_by	/event/event_producer/events_produced
ns:base.grecoromanmythology.greek_hero.roman_equivalent	/base/grecoromanmythology/roman_hero/greek_equivalent
ns:base.industrystandards.industry_standard.parts	/base/industrystandards/industry_standard/part_of
ns:base.pokervariants.poker_variant.based_on	/base/pokervariants/poker_variant/variations
ns:base.locations.states_and_provences.continent	/base/locations/continents/states_provinces_within
ns:user.narphorium.default_domain.product.brand	/user/narphorium/default_domain/brand/products
ns:base.sanfranciscoscene.san_francisco_promoter.events_promoted	/base/sanfranciscoscene/san_francisco_scene_event/promoters
ns:base.gambling.lottery.games	/base/gambling/lottery_game/lotteries
ns:sports.sports_team.team_mascot	/sports/mascot/team
ns:user.robert.tallest.building.preceded_by	/user/robert/tallest/building/suceeded_by
ns:base.webvideo.internet_video.broadcasters	/base/webvideo/internet_video_broadcaster/videos_broadcast
ns:computer.computer_peripheral_class.instances	/computer/computer_peripheral_class/instance_of
ns:digicams.digital_camera.manufacturer	/digicams/digital_camera_manufacturer/cameras
ns:base.livemusic.concert.venue	/base/livemusic/concert_venue/concerts
ns:base.folklore.mythical_creature.named_creatures_of_this_type	/base/folklore/named_mythical_creature/type_of_mythical_creature
ns:base.pipesmoking.pipe_tobacco.components	/base/pipesmoking/component_tobacco/pipe_tobaccos_with_this_component
ns:spaceflight.rocket.launch_sites	/spaceflight/rocket_launch_site/rockets_launched_here
ns:base.locations.countries.continent	/base/locations/continents/countries_within
ns:book.illustrator.magazine_issues_illustrated	/book/magazine_issue/interior_illustrations_by
ns:user.kurt.default_domain.thoughtranker.points_to	/user/kurt/default_domain/thoughtranker/revered_by
ns:base.icons.icon.represents	/base/icons/represented_by_icon/iconic_representations
ns:base.gadgets.gadget.brand	/base/gadgets/brand/products
ns:film.film.directed_by	/film/director/film
ns:user.chaswarner.default_domain.file_format.run_on	/user/chaswarner/default_domain/computing_platform/runs
ns:base.mapcentral.map_projection.map_projection_type	/base/mapcentral/map_projection_type/projections_of_this_type
ns:user.robert.roman_empire.roman_emperor.title	/user/robert/roman_empire/roman_emperor_title/emperors_with_this_title
ns:location.cn_autonomous_county.designated_minority	/people/chinese_ethnic_group/autonomous_counties
ns:user.sandos.computation.serialization.serializes	/user/sandos/computation/specification/has_serialization
ns:base.breakfast.breakfast_cereal_brand.ingredients	/base/breakfast/breakfast_cereal_ingredient/brands
ns:base.minerals.mineral.variety	/base/minerals/mineral/variety_of
ns:base.fight.protest.leaders_or_notable_protesters	/base/fight/protester/involved_in_protest
ns:base.bioventurist.bv_therapeutic.biomolecule_or_target	/base/bioventurist/biomolecule/therapeutics_involved
ns:base.bioventurist.technology_class.parent_technology	/base/bioventurist/technology_class/includes_technology
ns:base.fight.crime_type.includes_crimes	/base/fight/crime_type/included_in_crimes
ns:user.evening.default_domain.business_group.business_group_member	/user/evening/default_domain/business_group_member/business_group
ns:cvg.computer_videogame.influenced	/cvg/computer_videogame/influenced_by
ns:law.constitutional_amendment.proposed_by	/law/constitutional_amendment_proposer/constitutional_amendments_proposed
ns:base.motorcycle.motorcycle_series.motorcycle_subseries	/base/motorcycle/motorcycle_series/superseries
ns:base.abcbirds.conservation_project.lead_contact_person_s	/base/abcbirds/project_lead/project_s_coordinated
ns:medicine.infectious_disease.transmission	/medicine/transmission_route/infections_that_travel_this_way
ns:base.crime.lawyer.lawyer_type	/base/crime/lawyer_type/lawyers_of_this_type
ns:religion.religion.deities	/religion/deity/deity_of
ns:projects.project.project_focus	/projects/project_focus/projects
ns:base.tallships.museum_ships.associated_maritime_museum	/base/tallships/maritime_museum/associated_tall_ships
ns:user.alexander.default_domain.royal_house_member.royal_house	/user/alexander/default_domain/royal_house/members
ns:music.composition.lyricist	/music/lyricist/lyrics_written
ns:transportation.bridge.bridge_type	/transportation/bridge_type/bridges_of_this_type
ns:fictional_universe.fictional_organization.fictional_organization_founder	/fictional_universe/fictional_organization_founder/fictional_organizations_founded
ns:user.ramanan.default_domain.composition.musical_composer	/user/ramanan/default_domain/musical_composer/musical_composition
ns:base.pethealth.pet_disease_or_medical_condition.diagnosis	/base/pethealth/diagnosis/used_to_diagnose
ns:base.zionism.settlement.founded_by	/base/zionism/founder/founder_of
ns:base.argumentmaps.theoretical_argument.claims_this_is_true	/base/argumentmaps/theory/arguments_that_this_is_true
ns:fictional_universe.fictional_universe.literary_series_set_here	/book/literary_series/fictional_universe
ns:astronomy.telescope.housed_in	/astronomy/astronomical_observatory/telescope_s
ns:base.tallships.tall_ship.rig	/base/tallships/tall_ship_rig/ships_of_this_rig
ns:base.americancomedy.comedy_venue.notable_standup_performers	/base/americancomedy/comedian/performed_in_venues
ns:fictional_universe.event_in_fiction.appears_in_these_works	/fictional_universe/work_of_fiction/events
ns:organization.organization_relationship.child	/organization/organization/parent
ns:base.digitalcameras.digital_camera.lens_mount	/base/digitalcameras/lens_mount/digital_cameras
ns:base.zionism.settlement.type_of_settlement	/base/zionism/settlement_type/settlement_type_of
ns:user.skud.boats.vessel.built_at_shipyard	/user/skud/boats/shipyard/vessels_built_here
ns:exhibitions.exhibition.exhibits	/exhibitions/exhibit/exhibitions_displayed_in
ns:games.game.publisher	/games/game_publisher/games_published
ns:base.thoroughbredracing.thoroughbred_racehorse.breeder	/base/thoroughbredracing/thoroughbred_racehorse_breeder/horses_bred
ns:radio.radio_program.subjects	/radio/radio_subject/programs_with_this_subject
ns:base.conservationaction.coordinated_program.lead_agency_organization_s	/base/conservationaction/lead_agency_or_organization/program_s
ns:event.disaster.type_of_disaster	/event/disaster_type/disasters_of_this_type
ns:user.szaijan.fantasy_football.player.position	/user/szaijan/fantasy_football/position/player
ns:automotive.designer.automobiles_designed	/automotive/generation/designer
ns:event.disaster.structures_damaged	/event/disaster_affected_structure/damaged_by_disasters
ns:award.competition.winner	/award/competitor/competitions_won
ns:film.film_series.films_in_series	/film/film/film_series
ns:user.micahsaul.advertising.ad_campaign.advertised_thing	/user/micahsaul/advertising/advertised_thing/ad_campaigns
ns:automotive.make.model_s	/automotive/model/make
ns:business.trade_union.industry	/business/industry/trade_unions
ns:base.technologyofdoing.knowledge_worker_practice.includes	/base/technologyofdoing/knowledge_worker_practice/included_in
ns:base.paranormal.type_of_paranormal_event.includes_types_of_paranormal_event	/base/paranormal/type_of_paranormal_event/part_of_type
ns:base.breakfast.breakfast_cereal_brand.theme	/base/breakfast/breakfast_cereal_theme/brands
ns:cvg.computer_videogame.developer	/cvg/cvg_developer/games_developed
ns:base.politeuri.sparql_endpoint.biohacker	/base/politeuri/biohacker/responsible_for_sparql
ns:base.architecture2.structure2.built_on_site_of	/base/architecture2/destroyed_structure/site_replaced_by
ns:base.americancomedy.comedy_group.groups_formed_from_this_one	/base/americancomedy/comedy_group/formed_from
ns:opera.opera.genre	/opera/opera_genre/operas_in_this_genre
ns:fictional_universe.fictional_character.occupation	/fictional_universe/character_occupation/characters_with_this_occupation
ns:user.alexander.misc.murdered_person.murdered_by	/user/alexander/misc/murderer/people_murdered
ns:user.jamie.food.herb.complements	/user/jamie/food/herb_complement/complemented_by
ns:base.banned.banned_person.banning_agency	/base/banned/banning_agency/people_banned_by_this_agency
ns:base.motorcycle.motorcycle_manufacturer.series	/base/motorcycle/motorcycle_series/manufacturer
ns:base.goldenbooks.little_golden_books.author	/base/goldenbooks/golden_book_author/golden_books_written
ns:education.educational_institution.school_magazines	/education/school_magazine/school
ns:base.windenergy.wind_turbine_type.higher_classification	/base/windenergy/wind_turbine_type/lower_classification_s
ns:location.neighborhood.neighborhood_of	/location/place_with_neighborhoods/neighborhoods
ns:base.rollerderby.league.team	/base/rollerderby/team/member_of
ns:base.bioventurist.science_or_technology_company.develops_treatments_for_disease	/base/bioventurist/bv_medical_condition/company_involved
ns:architecture.museum.type_of_museum	/architecture/type_of_museum/museums
ns:meteorology.tropical_cyclone.affected_areas	/meteorology/cyclone_affected_area/cyclones
ns:base.monster.monster.monstrous_campaign_s	/base/monster/monstrous_works_of_fiction/featured_monster_s
ns:base.celebrations.celebration.celebration_subject	/base/celebrations/celebration_subject/event
ns:user.lukeschubert.default_domain.language_classification.higher_classification	/user/lukeschubert/default_domain/language_classification/lower_classifications
ns:medicine.medical_treatment.contraindications	/medicine/contraindication/contraindication_for
ns:geography.lake.lake_type	/geography/lake_type/lakes_of_this_type
ns:base.locations.cities_and_towns.state_province	/base/locations/states_and_provences/cities_within
ns:book.newspaper.owner	/book/newspaper_owner/newspapers_owned
ns:base.cryptography.cryptographer.ciphers_created	/base/cryptography/cipher/created_by
ns:food.tea.tea_type	/food/tea_type/tea
ns:base.crime.law_enforcement_authority.type_of_law_enforcement_agency	/base/crime/type_of_law_enforcement_agency/law_enforcement_agencies_of_this_type
ns:user.anne8.spa.massage.origin	/user/anne8/spa/massage_origin/massage_from_here
ns:location.metropolitan_area.category	/location/metropolitan_area_category/metro_areas
ns:base.bioventurist.technology_class.company_involved	/base/bioventurist/science_or_technology_company/area_of_expertise
ns:user.chaswarner.default_domain.file_format.written_by	/user/chaswarner/default_domain/computer_program/writes
ns:fashion.textile.weave	/fashion/weave/textiles_of_this_weave
ns:visual_art.artwork.artist	/visual_art/visual_artist/artworks
ns:base.thoroughbredracing.thoroughbred_racehorse.dam	/base/thoroughbredracing/thoroughbred_racehorse/foal_if_this_horse_is_dam
ns:base.argumentmaps.object_of_disputed_existence.arguments_that_it_doesn_t_exist	/base/argumentmaps/existential_argument/argues_this_doesn_t_exist
ns:base.athletics.athletics_championships_series.organized_by	/base/athletics/athletics_organization/events_organized
ns:base.recordingstudios.studio_album.studio_musician	/base/recordingstudios/studio_musician/albums_played_on
ns:comic_books.comic_book_series.featured_characters	/comic_books/comic_book_character/regular_featured_appearances
ns:spaceflight.satellite.orbiting	/astronomy/celestial_object/artificial_satellites
ns:theater.play.soundtracks	/theater/musical_soundtrack/play
ns:user.skud.sex.contraceptive_method.includes_methods	/user/skud/sex/contraceptive_method/included_by_methods
ns:religion.religion.holidays	/time/holiday/featured_in_religions
ns:architecture.structure.destroyed_by	/architecture/destruction_method/structures_destroyed
ns:cvg.computer_videogame.sequel	/cvg/computer_videogame/prequel
ns:music.artist.genre	/music/genre/artists
ns:architecture.architecture_firm.firm_partners	/architecture/architecture_firm_partners/partner_in_firm
ns:cvg.computer_videogame.peripherals_supported	/computer/computer_peripheral/supporting_games
ns:base.pinball.pinball_machine.based_on	/base/pinball/pinball_machine_basis/pinball_machines
ns:music.music_video.directed_by	/music/music_video_director/music_videos_directed
ns:computer.programming_language.language_paradigms	/computer/programming_language_paradigm/languages
ns:base.standardizedtesting.test_giving_organization.standardized_tests	/base/standardizedtesting/standardized_test/administrator
ns:base.warriors.clan.past_medicine_cats	/base/warriors/clan_cat/previously_medicine_cat_of
ns:base.process.process.output	/base/process/process_state/output_of
ns:user.skud.nuclear_weapons.nuclear_test.location	/user/skud/nuclear_weapons/nuclear_test_site/nuclear_tests
ns:base.caveart.region.caves	/base/caveart/cave/region
ns:base.horseracing.recurring_horse_race.form_of_horse_race	/base/horseracing/horse_race_form/horse_races
ns:tv.tv_genre.programs	/tv/tv_program/genre
ns:base.tallships.tall_ship_event_instance.ships_involved	/base/tallships/tall_ship/events_participated_in
ns:user.jamie.default_domain.sailboat.sailboat_class	/user/jamie/default_domain/sailboat_class/boats_in_class
ns:spaceflight.rocket.rocket_function	/spaceflight/rocket_function/rockets_supporting_this_function
ns:spaceflight.spacecraft.manufacturer	/spaceflight/satellite_manufacturer/spacecraft_manufactured
ns:base.horticulture.cultivar.male_parent	/base/horticulture/cultivar_parent/male_parent_of
ns:dining.chef.cuisines	/dining/cuisine/chefs
ns:religion.place_of_worship.type_of_place_of_worship	/religion/type_of_place_of_worship/places_of_worship
ns:base.anglican.church.archdioceses	/base/anglican/archdiocese/church
ns:base.animemanga.manga_title.animanga_franchise	/base/animemanga/anime_manga_franchise/manga_title
ns:boats.ship_class.designer	/boats/ship_designer/ship_classes_designed
ns:base.services.performance_venue.performance_type	/base/services/performing_art/venues
ns:law.legal_case.subject	/law/legal_subject/legal_cases
ns:visual_art.art_series.artist	/visual_art/visual_artist/art_series
ns:aviation.aircraft_designer.aircraft_models_designed	/aviation/aircraft_model/designed_by
ns:fictional_universe.work_of_fiction.setting	/fictional_universe/fictional_setting/works_set_here
ns:base.computerscience.data_structure.specialization_of	/base/computerscience/data_structure/specializations
ns:computer.computer.processor	/computer/computer_processor/used_in_computers
ns:base.database.database.financial_supporter_s	/base/database/database_financial_supporter/database_s
ns:user.zeusi.default_domain.sport_governing_body.series_organized	/user/zeusi/default_domain/sports_series/organizer
ns:base.fictionaluniverse.fictional_clone_creator.clones_created	/base/fictionaluniverse/fictional_clone/created_by
ns:exhibitions.exhibition_subject.exhibitions_created_about_this_subject	/exhibitions/exhibition/subjects
ns:base.advertisingcharacters.advertising_character.product	/base/advertisingcharacters/product/advertising_characters
ns:base.change.changing_thing.changes	/base/change/change/input
ns:base.onlineadvertising.ad_network.ad_types	/base/onlineadvertising/ad_type/ad_networks
ns:protected_sites.natural_or_cultural_site_designation.categories	/protected_sites/site_listing_category/category_of
ns:ice_hockey.hockey_division.conference	/ice_hockey/hockey_conference/divisions
ns:government.government_office_category.offices	/government/government_office_or_title/category
ns:base.vermont.vermont_fresh_network.sells_to	/base/vermont/vermont_fresh_network/buys_from
ns:government.government.agency	/government/government_agency/government
ns:amusement_parks.ride.designer	/amusement_parks/ride_designer/rides
ns:tv.tv_program.spin_offs	/tv/tv_program/spun_off_from
ns:geography.island.body_of_water	/geography/body_of_water/islands
ns:base.peleton.road_bicycling_race.road_bicycling_races_held	/base/peleton/road_bicycle_racing_event/road_cycling_race_this_is_an_event_of
ns:measurement_unit.magnetic_flux_unit.measurement_system	/measurement_unit/measurement_system/magnetic_flux_units
ns:computer.computer_processor.manufacturers	/computer/processor_manufacturer/processors_manufactured
ns:protected_sites.natural_or_cultural_site_designation.listing_agency	/protected_sites/natural_or_cultural_preservation_agency/natural_or_cultural_listings_maintained
ns:user.micahsaul.advertising.ad_campaign.advertiser	/user/micahsaul/advertising/advertiser/ad_campaigns
ns:conferences.conference.series	/conferences/conference_series/conference
ns:base.horticulture.cultivar.origin	/base/horticulture/cultivar_origin/cultivar
ns:food.type_of_dish.dishes	/food/dish/type_of_dish1
ns:computer.file_format.used_on	/computer/computing_platform/file_formats_supported
ns:base.typefaces.typeface.style_classification	/base/typefaces/typeface_classification/typefaces
ns:food.cheese.source_of_milk	/food/cheese_milk_source/cheeses
ns:medicine.drug.drug_class	/medicine/drug_class/drugs
ns:book.magazine_issue.magazine	/book/magazine/issues
ns:tv.tv_series_episode.series	/tv/tv_program/episodes
ns:user.robert.earthquakes.seismic_fault.earthquakes	/user/robert/earthquakes/earthquake/fault
ns:theater.theater_character.plays_appears_in	/theater/play/characters
ns:base.crime.criminal_organisation.type_of_criminal_organization	/base/crime/type_of_criminal_organization/criminal_organizations_of_this_type
ns:food.ingredient.compatible_with_dietary_restrictions	/food/dietary_restriction/compatible_ingredients
ns:protected_sites.protected_site.iucn_category	/protected_sites/iucn_category/protected_areas
ns:business.product_line.parent_product_line	/business/product_line/includes_product_lines
ns:medicine.disease.prevention_factors	/medicine/condition_prevention_factors/conditions_this_may_prevent
ns:aviation.airliner_accident.operator	/aviation/airline/accidents
ns:user.robert.us_congress.house_committee.current_members	/user/robert/us_congress/us_representative/committee_memberships
ns:fictional_universe.fictional_character.place_of_birth	/fictional_universe/fictional_setting/fictional_characters_born_here
ns:business.product_line.brand	/business/brand/product_lines
ns:user.alexander.default_domain.chess_opening.variation_of	/user/alexander/default_domain/chess_opening/variations
ns:base.argumentmaps.theory.arguments_that_this_is_false	/base/argumentmaps/theoretical_argument/claims_this_is_false
ns:astronomy.star.constellation	/astronomy/constellation/contains
ns:base.catalog.cataloged_composer.music_catalog	/base/catalog/music_catalog/cataloged_composer
ns:base.fictionaluniverse.fictional_impersonator.impersonated	/base/fictionaluniverse/impersonated_fictional_character/impersonated_by
ns:theater.theater_production.performed_at	/theater/theater/theatrical_productions_staged_here
ns:base.folklore.mythical_creature.area_of_occurrence	/base/folklore/mythical_creature_location/mythical_creature_s
ns:user.skud.nuclear_weapons.nuclear_test_series.site_s	/user/skud/nuclear_weapons/nuclear_test_site/nuclear_test_series
ns:business.product_theme.product_lines	/business/product_line/themes
ns:aviation.aircraft_model.aircraft_type	/aviation/aircraft_type/aircraft_of_this_type
ns:user.micahsaul.five_alarm_food.chili_pepper.species	/user/micahsaul/five_alarm_food/chili_species/chili_peppers_of_this_species
ns:biology.organism_classification.higher_classification	/biology/organism_classification/lower_classifications
ns:distilled_spirits.spirit_blender.blends	/distilled_spirits/blended_spirit/blender
ns:user.robert.roman_empire.roman_emperor.emperor_of	/user/robert/roman_empire/roman_region/emperors
ns:geography.mountain_range.passes	/geography/mountain_pass/range
ns:base.mystery.cryptid_classification.cryptid_s_of_this_classification	/base/mystery/cryptid/type_of_cryptid
ns:user.alexander.default_domain.royal_house_member.title	/user/alexander/default_domain/royal_title/title_holders
ns:user.uoa_it.uoa_it.uoa_technology_type.uoa_technology	/user/uoa_it/uoa_it/uoa_technology/technology_type
ns:people.person.place_of_birth	/location/location/people_born_here
ns:base.endofallthings.apocalypses_scientific.apocalyptical_scale	/base/endofallthings/apocalyptic_scale/theorized_apocalypse
ns:base.yalebase.residential_college.master	/base/yalebase/college_master/master_of_college
ns:base.computerscience.computational_problem.complexity	/base/computerscience/complexity_class/problems
ns:base.americancomedy.celebrity_impressionist.celebrities_impersonated	/base/americancomedy/impersonated_celebrity/impersonated_by
ns:base.activism.activism_issue.parent_issue	/base/activism/activism_issue/includes_issues
ns:base.crime.execution.execution_method	/base/crime/execution_type/people_executed_this_way
ns:base.database.database.data_contributor_s	/base/database/data_contributor/contributed_to_data_set_s
ns:base.argumentmaps.thinker.thinks_this_didn_t_happen	/base/argumentmaps/event_of_disputed_occurance/people_who_think_it_didn_t_happen
ns:user.narphorium.default_domain.beer_style.specialization_of	/user/narphorium/default_domain/beer_style/specializations
ns:film.film.sequel	/film/film/prequel
ns:business.consumer_product.brand	/business/brand/products
ns:base.terrorism.terrorist_organization.involved_in_attacks	/base/terrorism/terrorist_attack/organizations_involved
ns:music.album.genre	/music/genre/albums
ns:theater.theater_production.play	/theater/play/productions
ns:exhibitions.exhibition.curators	/exhibitions/exhibition_curator/exhibitions_curated
ns:fictional_universe.fictional_organization_type.organizations	/fictional_universe/fictional_organization/type_of_organization
ns:base.animemanga.manga_publisher.manga_titles_published	/base/animemanga/manga_title/manga_publisher
ns:geography.body_of_water.bridges	/transportation/bridge/body_of_water_spanned
ns:military.military_service.rank	/military/rank/used_by_services
ns:business.product_theme.products	/business/consumer_product/themes
ns:sports.sports_league.championship	/sports/sports_championship/league
ns:architecture.engineer.projects	/architecture/structure/engineer
ns:tv.tv_location.tv_shows_filmed_here	/tv/tv_program/filming_locations
ns:user.synedra.didwho.parent.child	/user/synedra/didwho/person/parent
ns:base.schemastaging.protected_site_extra.category	/base/schemastaging/protected_site_category/protected_sites
ns:user.yqbd.ideology.ideology.proponents	/user/yqbd/ideology/ideology/advocates
ns:user.alexander.misc.murdered_person.murder_method	/user/alexander/misc/murder_method/murders
ns:education.educational_institution.school_type	/education/school_category/schools_of_this_kind
ns:music.composition.recordings	/music/recording/song
ns:comic_books.comic_book_story.colors	/comic_books/comic_book_colorist/comic_stories_colored
ns:interests.collection_activity.type_of_thing_collected	/interests/collection_category/name_of_collection_activity
ns:architecture.engineer.partner_in_firm	/architecture/engineering_firm/partners
ns:base.militaryinfiction.military_conflict_in_fiction.military_characters_involved	/base/militaryinfiction/military_character/participated_in_conflicts
ns:base.scenicbyways.scenic_byway.byway_program	/base/scenicbyways/scenic_byway_program/byways
ns:influence.peer_relationship.peers	/influence/influence_node/peers
ns:sports.sports_team.arena_stadium	/sports/sports_facility/teams
ns:base.morelaw.law.subject_type	/base/morelaw/type_of_legal_subject/laws_in_this_field
ns:book.translated_work.translations	/book/translation/translation_of
ns:automotive.model.successor	/automotive/model/predecessor
ns:food.ingredient.cuisine	/dining/cuisine/ingredients
ns:internet.top_level_domain.sponsor	/internet/top_level_domain_sponsor/domains
ns:government.governmental_jurisdiction.government_bodies	/government/governmental_body/jurisdiction
ns:base.braziliangovt.politician.represented_state	/base/braziliangovt/state/politicians
ns:biology.gene_ontology_group.part_group	/biology/gene_ontology_group/aggregate_group
ns:time.event.instance_of_recurring_event	/time/recurring_event/instances
ns:measurement_unit.illuminance_unit.measurement_system	/measurement_unit/measurement_system/illuminance_units
ns:astronomy.orbital_relationship.orbits	/astronomy/orbital_relationship/orbited_by
ns:user.narphorium.people.notable_siblings.siblings	/user/narphorium/people/notable_person/part_of_notable_siblings
ns:travel.accommodation.features	/travel/accommodation_feature/accommodation_with_this_feature
ns:engineering.channel_access_method.parent_method	/engineering/channel_access_method/child_method
ns:base.dancingwiththestars.contestant.professional_dance_partner	/base/dancingwiththestars/professional_performer/celebrity_dance_partner
ns:film.content_rating.film_rating_system	/film/content_rating_system/film_ratings
ns:internet.blog.blogger	/internet/blogger/blog
ns:education.university.fraternities_and_sororities	/education/fraternity_sorority/colleges_and_universities
ns:medicine.vaccine.developed_by	/medicine/vaccine_developer/vaccine
ns:ice_hockey.hockey_player.hockey_position	/ice_hockey/hockey_position/players
ns:user.brendan.musician_products.product_model.brand_name	/user/brendan/musician_products/brand/products
ns:time.holiday.day_of_year	/time/day_of_year/holidays
ns:games.game.designer	/games/game_designer/games_designed
ns:base.breakfast.breakfast_cereal_brand.varieties	/base/breakfast/breakfast_cereal_brand/variety_of
ns:user.pak21.default_domain.tectonic_plate_boundary.plates	/user/pak21/default_domain/tectonic_plate/boundaries
ns:base.fires.fire_department.firefighters	/base/fires/firefighter/belongs_to_fire_department
ns:base.bio2rdf.bm.link_to	/base/bio2rdf/bm/link_from
ns:media_common.quotation.source	/media_common/quotation_source/quotations
ns:base.cocktails.cocktail.standard_garnish	/base/cocktails/cocktail_garnish/cocktails_with_this_garnish
ns:basketball.basketball_team.division	/basketball/basketball_division/teams
ns:military.military_unit_size.units_of_this_type	/military/military_unit/unit_size
ns:visual_art.art_series.artworks	/visual_art/artwork/belongs_to_series
ns:user.buxul.default_domain.german_political_party.members	/user/buxul/default_domain/german_politician/political_party1
ns:aviation.airport.serves	/location/location/nearby_airports
ns:olympics.olympic_sport.olympic_games_contested	/olympics/olympic_games/sports
ns:meteorology.tropical_cyclone_season.tropical_cyclones	/meteorology/tropical_cyclone/tropical_cyclone_season
ns:book.illustrator.books_illustrated	/book/book/interior_illustrations_by
ns:base.technologyofdoing.knowledge_worker_practice.parent_practice	/base/technologyofdoing/knowledge_worker_practice/derivatives
ns:baseball.baseball_division.league	/baseball/baseball_league/divisions
ns:user.skud.boats.sailing_vessel_rig.included_in_rig	/user/skud/boats/sailing_vessel_rig/includes_rigs
ns:user.skud.boats.vessel_use.vessels	/user/skud/boats/vessel/use
ns:royalty.order_of_chivalry.category	/royalty/order_of_chivalry_category/orders_in_this_category
ns:medicine.disease.treatments	/medicine/medical_treatment/used_to_treat
ns:book.author.works_written	/book/written_work/author
ns:base.warriors.clan.past_leaders	/base/warriors/clan_cat/previously_leader_of
ns:base.paranormal.paranormal_event.attributed_to_person	/base/paranormal/person_with_alleged_paranormal_powers/allegedly_responsible_for_paranormal_event
ns:music.release.label	/music/record_label/releases
ns:american_football.football_team.current_head_coach	/american_football/football_coach/current_team_head_coached
ns:music.instrument.family	/music/instrument/variation
ns:sports.sports_team.sport	/sports/sport/teams
ns:location.metropolitan_area.anchor_city	/location/metropolitan_area_anchor/metropolitan_area
ns:law.legal_case.judges	/law/judge/cases
ns:music.concert_tour.concert_films_or_videos	/music/concert_film/concert_tour
ns:fictional_universe.fictional_character.species	/fictional_universe/character_species/characters_of_this_species
ns:award.hall_of_fame.discipline	/award/hall_of_fame_discipline/halls_of_fame
ns:business.acquisition.acquiring_company	/organization/organization/companies_acquired
ns:base.bioventurist.technology_class.related_technology	/base/bioventurist/technology_class/related_technology1
ns:cvg.computer_videogame.uses_game_engine	/cvg/computer_game_engine/used_for_computer_games
ns:base.locations.states_and_provences.country	/base/locations/countries/states_provinces_within
ns:law.legal_case.court	/law/court/legal_cases
ns:astronomy.extraterrestrial_location.type_of_planetographic_feature	/astronomy/type_of_planetographic_feature/planetographic_features_of_this_type
ns:base.writing.symset.hypernym	/base/writing/symset/hyponym
ns:aviation.airport_operator.airports_operated	/aviation/airport/operator
ns:base.militaryinfiction.event_in_fiction.includes_events	/base/militaryinfiction/event_in_fiction/included_by_these_events
ns:business.acquisition.company_acquired	/organization/organization/acquired_by
ns:business.shopping_center.store	/business/business_location/in_shopping_center
ns:education.athletics_brand.teams	/sports/school_sports_team/athletics_brand
ns:base.ecology.type_of_ecosystem.includes_types_of_ecosystem	/base/ecology/type_of_ecosystem/included_in_ecosystem_type
ns:base.locations.place_in_the_world.country	/base/locations/countries/places_within
ns:base.activism.activism_issue.related_protests_etc	/base/activism/activist_event/related_issues
ns:religion.religion.texts	/religion/religious_text/religious_text_of
ns:astronomy.galaxy.galactic_group	/astronomy/galactic_group/galaxies_in_group
ns:travel.travel_destination.tourist_attractions	/travel/tourist_attraction/near_travel_destination
ns:visual_art.art_period_movement.associated_artworks	/visual_art/artwork/period_or_movement
ns:martial_arts.martial_artist.instructor	/martial_arts/martial_artist/martial_arts_students
ns:base.eating.diets.people_who_follow_this_diet	/base/eating/practicer_of_diet/diet
ns:sports.sports_league.sport	/sports/sport/leagues
ns:film.film_festival.focus	/film/film_festival_focus/festivals_with_this_focus
ns:sports.sports_championship_event.champion	/sports/sports_team/championships
ns:soccer.football_league.governing_body	/soccer/fifa/leagues_governed
ns:base.database.database.database_host	/base/database/database_host/database_s
ns:base.qualia.type_of_disability.support_advocacy_groups	/base/qualia/disability_organization/disability
ns:fictional_universe.fictional_character.parents	/fictional_universe/fictional_character/children
ns:base.ancientegypt.tomb.excavated_by	/base/ancientegypt/tomb_excavator/tombs_excavated
ns:law.us_patent.inventor	/law/inventor/us_patents
ns:base.aareas.schema.administrative_area.administrative_parent	/base/aareas/schema/administrative_area/administrative_children
ns:distilled_spirits.blended_spirit.style	/distilled_spirits/blended_spirit_style/blends
ns:base.thoroughbredracing.thoroughbred_racehorse.sex	/base/thoroughbredracing/thoroughbred_racehorse_sex/horses_of_this_sex
ns:measurement_unit.luminous_flux_unit.measurement_system	/measurement_unit/measurement_system/luminous_flux_units
ns:measurement_unit.radioactivity_unit.measurement_system	/measurement_unit/measurement_system/radioactivity_units
ns:base.bigsky.site.landing_zone	/base/bigsky/landing_zone/flying_site
ns:base.webvideo.internet_video_series.broadcasters	/base/webvideo/internet_video_broadcaster/series
ns:american_football.football_team.conference	/american_football/football_conference/teams
ns:people.deceased_person.place_of_burial	/people/place_of_interment/interred_here
ns:measurement_unit.charge_unit.measurement_system	/measurement_unit/measurement_system/charge_units
ns:user.alexander.philosophy.philosopher.era	/user/alexander/philosophy/era/philosophers
ns:base.americancivilwar.battle.ships_involved_in_this_conflict	/base/americancivilwar/ship/conflicts_involved_in
ns:medicine.drug_brand.canonical_drug	/medicine/drug/canonical_brands
ns:user.thadguidry.default_domain.bread.cereal_grains_used	/user/thadguidry/default_domain/cereal_grain/breads_made_with
ns:travel.hotel.operating_brand	/travel/hotel_brand/hotels_in_this_brand
ns:base.argumentmaps.morally_disputed_activity.moral_defence	/base/argumentmaps/moral_defence/morally_disputed_activity
ns:base.argumentmaps.innovative_work.originalidea	/base/argumentmaps/original_idea/first_appears_in_work
ns:base.fictionaluniverse.fictional_spacecraft.spacecraft_class	/base/fictionaluniverse/fictional_spacecraft_class/ships
ns:base.americancomedy.double_act.comic	/base/americancomedy/double_act_comic/comic_in_double_act
ns:user.techgnostic.default_domain.newspaper.market_areas	/user/techgnostic/default_domain/market_area/newspaper
ns:base.fictionaluniverse.cloned_character.clones	/base/fictionaluniverse/fictional_clone/clone_of
ns:visual_art.artwork.art_genre	/visual_art/visual_art_genre/artworks
ns:base.sails.sailing_ship.sailing_ship_type	/base/sails/sailboat/ships
ns:base.argumentmaps.idea.included_in	/base/argumentmaps/idea/includes
ns:travel.accommodation.accommodation_type	/travel/accommodation_type/accommodation_of_this_type
ns:base.handball.handball_organization.leagues_governed	/base/handball/handball_league/governing_body
ns:base.armoryshow1913.exhibited_artist.exhibited_work	/base/armoryshow1913/exhibited_artwork/artist
ns:fictional_universe.character_species.found_in_fictional_universe	/fictional_universe/fictional_universe/species
ns:aviation.airport.hub_for	/aviation/airline/hubs
ns:user.jefft0.default_domain.purebred_dog.breed	/user/jefft0/default_domain/dog_breed/dogs_of_this_breed
ns:user.rcheramy.default_domain.manufacturer.products	/user/rcheramy/default_domain/product/manufacturer1
ns:metropolitan_transit.transit_line.terminuses	/metropolitan_transit/transit_stop/terminus_for_lines
ns:fictional_universe.fictional_universe.works_set_here	/fictional_universe/work_of_fiction/part_of_these_fictional_universes
ns:tv.multipart_tv_episode.tv_program	/tv/tv_program/multipart_episodes
ns:computer.computer_peripheral.peripheral_class	/computer/computer_peripheral_class/products
ns:base.gadgets.gadget.successor	/base/gadgets/gadget/predecessor
ns:measurement_unit.measurement_system.pressure_units	/measurement_unit/pressure_unit/measurement_system
ns:tv.tv_soundtrack.tv_program	/tv/tv_program/soundtrack
ns:comic_books.comic_book_series.continues	/comic_books/comic_book_series/continued_by
ns:language.language_writing_system.child_writing_systems	/language/language_writing_system/parent_writing_systems
ns:film.film.costume_design_by	/film/film_costumer_designer/costume_design_for_film
ns:broadcast.radio_station.format	/broadcast/radio_format/stations
ns:film.film.film_art_direction_by	/film/film_art_director/films_art_directed
ns:spaceflight.satellite.launch_vehicle	/spaceflight/rocket/satellites_launched
ns:base.webvideo.internet_video_series.series_creator	/base/webvideo/internet_video_creator/series_created
ns:base.cdnpolitics.bill.tabled_by	/base/cdnpolitics/member_of_parliament/bills_tabled
ns:base.lawsandbox.statute.amends	/base/lawsandbox/statute/amended_by
ns:base.yalebase.publication.alumni	/base/yalebase/person/worked_on_publications
ns:olympics.olympic_sport.games_contested_as_demonstration	/olympics/olympic_games/demonstration_sports
ns:business.issuer.issue	/business/issue/issuer
ns:base.yalebase.residential_college.dean	/base/yalebase/college_dean/dean_of_college
ns:medicine.physician.medical_specialty	/medicine/medical_specialty/physicians_with_this_specialty
ns:education.athletics_brand.institution	/education/educational_institution/athletics_brand
ns:cvg.musical_game.input_method	/cvg/input_method/games_using_this
ns:base.peleton.road_bicycle_racing_event.team_competion_winner	/base/peleton/cycling_team_professional/race_s_won_for_the_team_competition
ns:astronomy.extraterrestrial_location.contained_by	/astronomy/extraterrestrial_location/contains
ns:user.cheunger.sports_test.sports_team.current_members	/user/cheunger/sports_test/team_athlete/current_team_membership
ns:user.giladgoren.default_domain.telecom_equipment.technology	/user/giladgoren/default_domain/network/equipment
ns:government.election_campaign.candidate	/government/politician/election_campaigns
ns:media_common.adaptation.adapted_from	/media_common/adapted_work/adaptations
ns:base.tallships.tall_ship_rig.included_in_rig	/base/tallships/tall_ship_rig/includes_rigs
ns:military.military_combatant.includes_allies	/military/military_combatant/belongs_to_combatant_group
ns:base.warriors.clan.current_leader	/base/warriors/clan_cat/currently_leader_of
ns:base.argumentmaps.idea.assumptions	/base/argumentmaps/idea/progeny
ns:base.locations.cities_and_towns.country	/base/locations/countries/cities_within
ns:base.nascar.nascar_race.venue	/base/nascar/nascar_venue/nascar_races_held_here
ns:food.beer.brewery_brand	/food/brewery_brand_of_beer/beers_produced
ns:user.tsegaran.computer.algorithm.family	/user/tsegaran/computer/algorithm_family/algorithm
ns:base.inspiration.inspiration.inspired_by	/base/inspiration/inspiration/inspiration_for
ns:architecture.structure.contractor	/architecture/architectural_contractor/projects
ns:sports.sports_championship.events	/sports/sports_championship_event/championship
ns:automotive.model.automotive_class	/automotive/automotive_class/examples
ns:base.breakfast.breakfast_cereal_brand.mascot	/base/breakfast/breakfast_cereal_mascot/brand
ns:base.mystery.cryptid.alternative_organism	/base/mystery/cryptid_alternative/possible_cryptid_source
ns:olympics.olympic_games.host_city	/olympics/olympic_host_city/olympics_hosted
ns:user.jamie.food.food_additive_category.categorizes	/user/jamie/food/food_additive/category
ns:fictional_universe.fictional_character.ethnicity	/fictional_universe/ethnicity_in_fiction/characters_of_this_ethnicity
ns:base.petbreeds.dog_breed.color	/base/petbreeds/dog_coat_color/dog_breeds
ns:law.constitution.constitutional_convention	/law/constitutional_convention/constitution
ns:time.holiday.type_of_holiday	/time/holiday_category/holidays
ns:base.aubreymaturin.character.based_on	/base/aubreymaturin/real_person/characters_based_on_this_person
ns:award.award.presented_by	/award/award_presenting_organization/awards_presented
ns:base.argumentmaps.morally_disputed_activity.instance_of_abstract_moral_dispute	/base/argumentmaps/abstract_moral_dispute/particular_instances
ns:medicine.disease.includes_diseases	/medicine/disease/parent_disease
ns:base.technologyofdoing.knowledge_worker_practice.related_to	/base/technologyofdoing/knowledge_worker_practice/related_from
ns:base.jewlib.research_collection.originators	/base/jewlib/original_owner/originator_of
ns:base.adventures.adventure_game.theme	/base/adventures/computer_game_theme/games
ns:rail.railway.terminuses	/rail/railway_terminus/railways_terminating_here
ns:internet.website.category	/internet/website_category/sites
ns:cvg.computer_game_rating_system.ratings	/cvg/computer_game_rating/rating_system
ns:comic_strips.comic_strip.genre	/comic_strips/comic_strip_genre/comic_strips_of_this_genre
ns:spaceflight.bipropellant_rocket_engine.fuel	/spaceflight/rocket_engine_fuel/rocket_engines
ns:book.school_or_movement.associated_works	/book/written_work/school_or_movement
ns:base.rugby.rugby_coach.type_of_rugby	/base/rugby/type_of_rugby/coaches_of_this_type
ns:measurement_unit.measurement_system.temperature_units	/measurement_unit/temperature_unit/measurement_system
ns:base.engineering.dam.purpose_of_dam	/base/engineering/water_reservoir_use/dams_with_this_purpose
ns:conferences.conference_sponsor.conferences	/conferences/conference_series/sponsoring_organization
ns:biology.organism.parents	/biology/organism/children
ns:user.yarnover.default_domain.handcrafted_object.was_made_using_the_technique_of	/user/yarnover/default_domain/handcraft_technique/was_used_in
ns:measurement_unit.measurement_system.time_units	/measurement_unit/time_unit/measurement_system
ns:event.disaster.surviving_structures	/event/disaster_affected_structure/survived_disasters
ns:computer.computer.key_designers	/computer/computer_designer/computers_designed
ns:amusement_parks.roller_coaster.material	/amusement_parks/roller_coaster_material/roller_coasters
ns:base.politicalconventions.political_convention.presidential_nominee	/base/politicalconventions/presidential_nominee/nominated_at
ns:base.folklore.mythology.location_of_origin	/base/folklore/mythology_origin_location/mythologies_originating_here
ns:comic_books.comic_book_story.inks	/comic_books/comic_book_inker/comic_books_inked
ns:base.folklore.location_in_mythology.mythology	/base/folklore/mythology/referenced_location_s
ns:base.change.process.subprocesses	/base/change/process/part_of_process
ns:fictional_universe.school_in_fiction.students_graduates	/fictional_universe/fictional_character/education
ns:engineering.piston_engine.piston_configuration	/engineering/piston_configuration/engines
ns:base.farmfed.food_product.produced_by	/base/farmfed/producer/produces
ns:comic_books.comic_book_character.created_by	/comic_books/comic_book_creator/characters_created
ns:protected_sites.protected_site.governing_body	/protected_sites/governing_body_of_protected_sites/protected_sites_governed
ns:user.akatenev.weapons.weapon.variants	/user/akatenev/weapons/weapon/variant_of
ns:music.producer.releases_produced	/music/release/producers
ns:law.constitutional_amendment.constitution	/law/constitution/amendments
ns:music.release.track	/music/recording/releases
ns:base.bigsky.site.launch	/base/bigsky/launch/site
ns:base.trails.trail.trailhead	/base/trails/trailhead/trails
ns:physics.particle_family.parent_class	/physics/particle_family/subclasses
ns:location.hud_county_place.county	/location/us_county/hud_county_place
ns:cvg.computer_videogame.peripheral_classes_supported	/computer/computer_peripheral_class/supporting_games
ns:travel.travel_destination.tour_operators	/travel/tour_operator/travel_destinations
ns:base.activism.activist.area_of_activism	/base/activism/activism_issue/activists
ns:computer.programming_language.language_designers	/computer/programming_language_designer/languages_designed
ns:geography.island.island_group	/geography/island_group/islands_in_group
ns:base.mystery.cryptid_classification.area_of_occurrence	/base/mystery/cryptid_observation_location/cryptid_s_occurring_here
ns:base.filmcameras.camera.manufacturer	/base/filmcameras/camera_manufacturer/cameras_manufactured
ns:location.location.contains	/location/location/containedby
ns:computer.computer_emulator.computer	/computer/computer/emulators
ns:music.release.album	/music/album/releases
ns:time.holiday.holiday_period	/time/holiday_period/holidays
ns:base.triggers.triggery_material.part_of_fictional_universe	/base/triggers/fictional_universe_with_triggers/triggery_material
ns:basketball.basketball_team.conference	/basketball/basketball_conference/teams
ns:base.schemastaging.body_of_water_extra.fish	/base/schemastaging/fish/found_in
ns:user.skud.sex.sexual_orientation.part_of_broader_orientation	/user/skud/sex/sexual_orientation/includes_narrower_orientations
ns:geography.mountain_range.mountains	/geography/mountain/mountain_range
ns:base.argumentmaps.practical_problem.proposed_solution	/base/argumentmaps/proposed_solution/problem
ns:award.ranked_item.appears_in_ranked_lists	/award/ranking/item
ns:base.infrastructure.power_station.fuel_type	/base/infrastructure/power_plant_type/power_station
ns:base.onephylogeny.type_of_thing.includes	/base/onephylogeny/type_of_thing/included_in
ns:film.film.featured_film_locations	/film/film_location/featured_in_films
ns:measurement_unit.force_moment_unit.measurement_system	/measurement_unit/measurement_system/force_moment_units
ns:base.pethealth.pet_disease_or_medical_condition.pets_affected	/base/pethealth/pet_with_medical_condition/diseases_and_other_conditions_of_this_pet
ns:type.object.type	/type/type/instance
ns:spaceflight.rocket_engine.designed_by	/spaceflight/rocket_engine_designer/rocket_engines
ns:base.engineeringdraft.manufactured_component_category.meronyms	/base/engineeringdraft/manufactured_component_category/holonyms
ns:base.wordnet.word_sense.antonym	/base/wordnet/antonym_relation/antonym
ns:base.grecoromanmythology.greek_deity.roman_equivalent	/base/grecoromanmythology/roman_deity/greek_equivalent
ns:comic_books.comic_book_character.primary_universe	/comic_books/comic_book_fictional_universe/characters_primarily_appearing_in_this_universe
ns:base.wastrology.astrologicalplanet.astrologicalrulership	/base/wastrology/zodiacsign/astrologicalrulership
ns:measurement_unit.measurement_system.power_units	/measurement_unit/power_unit/measurement_system
ns:music.genre.subgenre	/music/genre/parent_genre
ns:base.peleton.cycling_team_professional.cycling_team_status	/base/peleton/cycling_organization_membership/cycling_teams_of_this_rank
ns:medicine.disease_cause.diseases	/medicine/disease/causes
ns:base.danceporn.video.dancer	/base/danceporn/dancer/music_video
ns:spaceflight.rocket_launch_site.operated_by	/spaceflight/space_agency/spaceports
ns:theater.theater_production.producing_company	/theater/theater_company/plays_produced
ns:user.narphorium.default_domain.profession.specialization_of	/user/narphorium/default_domain/profession/specializations
ns:baseball.baseball_team.league	/baseball/baseball_league/teams
ns:base.fires.explosion.propellant	/base/fires/explosive_substance/explosions_caused_this_way
ns:medicine.hospital.medical_specialties	/medicine/medical_specialty/hospitals_with_this_specialty
ns:user.alexbl.congressional_voting_records.congressional_member.bills_sponsored	/user/alexbl/congressional_voting_records/bill/sponsored_by
ns:government.government_position_held.basic_title	/government/government_office_category/officeholders
ns:base.ancientegypt.pyramid.owner	/base/ancientegypt/pyramid_owner/pyramid_owned
ns:law.constitutional_convention.delegates	/law/constitutional_convention_delegate/constitutional_conventions
ns:base.sameas.consuming_api.api_format	/base/sameas/consuming_api_format/apis
ns:time.month.calendar_system	/time/calendar/months
ns:base.puzzles.puzzle_constructor.puzzle	/base/puzzles/puzzle/created_by
ns:fictional_universe.fictional_object.destroyer	/fictional_universe/fictional_object_destroyer/fictional_objects_destroyed
ns:boats.ship.designer	/boats/ship_designer/boats_designed
ns:automotive.model_year.model	/automotive/model/model_years
ns:base.abcbirds.conservation_plan.focal_location	/base/litcentral/focal_location/conservation_plan_s
ns:base.wrestling.professional_wrestling_manager.managed	/base/wrestling/solo_wrestler_or_team/managers
ns:food.cheese.certification	/food/cheese_certification/certified_cheeses
ns:organization.organization.founders	/organization/organization_founder/organizations_founded
ns:comic_books.comic_book_story.characters	/comic_books/comic_book_character/story_specific_appearances
ns:government.legislative_committee.legislature	/government/governmental_body/committees
ns:cvg.computer_game_subject.games	/cvg/computer_videogame/subjects
ns:base.monster.fictional_deceased_character.victim_of_this_monster	/base/monster/monster/victim_s
ns:conferences.conference_series.geographical_scope	/base/events/geographical_scope/conferences_and_conventions_with_this_geographic_scope
ns:visual_art.visual_artist.art_forms	/visual_art/visual_art_form/artists
ns:base.athletics.athletics_meeting.venue	/user/zeusi/default_domain/athletics_venue/meetings_used_in
ns:distilled_spirits.distilled_spirit_type.fermentation_base	/distilled_spirits/fermentation_base/spirit_products
ns:religion.religion.types_of_places_of_worship	/religion/type_of_place_of_worship/religion
ns:user.duck1123.default_domain.primary_identity.alternate_identities	/user/duck1123/default_domain/alternate_persona/personae
ns:base.warriors.clan.past_deputies	/base/warriors/clan_cat/previously_deputy_of
ns:base.infection.biosafety_facility.location	/base/infection/location_of_biosafety_facility/biosafety_facility
ns:biology.breed_origin.breeds_originating_here	/biology/animal_breed/place_of_origin
ns:base.mystery.cryptid.area_of_occurrence	/base/mystery/cryptid_area_of_occurrence/cryptid_s_found_here
ns:digicams.digital_camera.sensor_type	/digicams/camera_sensor_type/digital_cameras
ns:soccer.football_match.teams	/soccer/football_team/matches
ns:astronomy.star_system.plutoids	/astronomy/plutoid/star_system
ns:sports.golf_course.designer	/sports/golf_course_designer/golf_courses
ns:fashion.garment.specialization_of	/fashion/garment/more_specialized_forms
ns:base.schemastaging.sumo_rank.higher_rank	/base/schemastaging/sumo_rank/lower_rank
ns:base.ecology.ecosystem.type_of_ecosystem	/base/ecology/type_of_ecosystem/ecosystems_of_this_type
ns:base.argumentmaps.moral_defence.supporter	/base/argumentmaps/moral_agent/disapproves_of_activity
ns:base.whamoworld.games_based_on_wham_o_products.wham_o_product_used	/base/whamoworld/wham_o_toys/game_s_using_this_product
ns:user.dylanrocks.national_football_league.nfl_player_who_has_been_suspended.suspended_by	/user/dylanrocks/national_football_league/nfl_suspending_party/nfl_player_who_has_been_suspended
ns:measurement_unit.inductance_unit.measurement_system	/measurement_unit/measurement_system/inductance_units
ns:measurement_unit.luminous_intensity_unit.measurement_system	/measurement_unit/measurement_system/luminous_intensity_units
ns:base.wrestling.solo_wrestler_or_team.members	/base/wrestling/professional_wrestler/member_of_team
ns:digicams.digital_camera.uncompressed_formats	/digicams/camera_uncompressed_format/cameras
ns:location.fr_region.departments	/location/fr_department/region
ns:computer.computer_processor.processor_family	/computer/computer_processor/variants
ns:base.ikariam.ikariam_buildings.research_required	/base/ikariam/ikariam_research/buildings_unlocked
ns:base.casinos.casino.theme	/base/casinos/casino_theme/casinos_in_this_theme
ns:base.exoplanetology.exoplanet.parent_star	/astronomy/star/planet_s
ns:measurement_unit.resistance_unit.measurement_system	/measurement_unit/measurement_system/resistance_units
ns:engineering.engine_category.sub_categories	/engineering/engine_category/category_of
ns:base.engineeringdraft.manufactured_component.variants	/base/engineeringdraft/manufactured_component/variation_of
ns:fictional_universe.fictional_universe.characters	/fictional_universe/fictional_character/appears_in_these_fictional_universes
ns:base.opposites.opposite.opposite	/base/opposites/opposite_relationship/opposite
ns:computer.computer_peripheral.compatible_computers	/computer/computer/peripherals
ns:influence.influence_node.influenced_by	/influence/influence_node/influenced
ns:geography.mountain.mountain_type	/geography/mountain_type/mountains_of_this_type
ns:base.onlineadvertising.ad_network.delivery_channels	/base/onlineadvertising/ad_delivery_channel/ad_networks
ns:user.joehughes.default_domain.transit_agency.route_stop_information	/user/joehughes/default_domain/transit_application/agencies
ns:base.sanfranciscoscene.san_francisco_draq_queen.drag_events_participated	/base/sanfranciscoscene/san_francisco_scene_event/drag_queen_participants
ns:music.group_member.vocal_range	/music/voice/singers
ns:fictional_universe.fictional_object.destruction_method	/fictional_universe/fictional_object_destruction_method/fictional_objects_destroyed
ns:user.joehughes.default_domain.transit_application.creators	/user/joehughes/default_domain/transit_application_creator/transit_applications
ns:base.centreforeresearch.software_technology.used_in_service	/base/centreforeresearch/service/software
ns:base.paranormal.paranormal_event.type_of_paranormal_event	/base/paranormal/type_of_paranormal_event/events_of_this_type
ns:geography.mountain.first_ascenders	/geography/mountaineer/first_ascents
ns:music.single.versions	/music/recording/canonical_version
ns:biology.organism_classification.rank	/biology/organism_classification_rank/organism_classifications
ns:education.field_of_study.subdisciplines	/education/field_of_study/subdiscipline_of
ns:games.game_expansion.game	/games/game/expansions
ns:base.athletics.athletics_country.national_federation	/base/athletics/athletics_organization/national_federation_of
ns:food.ingredient.incompatible_with_dietary_restrictions	/food/dietary_restriction/incompatible_ingredients
ns:education.department.institution	/education/university/departments
ns:education.department.field	/education/field_of_study/academic_departments
ns:computer.software.developer	/computer/software_developer/software
ns:base.motorcycle.motorcycle_make.model_s	/base/motorcycle/motorcycle_model/make
ns:people.profession.specializations	/people/profession/specialization_of
ns:base.filmcameras.camera.lens_mount	/base/filmcameras/lens_mount/cameras
ns:internet.top_level_domain.domain_type	/internet/top_level_domain_type/domains
ns:cvg.game_version.game	/cvg/computer_videogame/versions
ns:user.daepark.default_domain.golf_club.make	/user/daepark/default_domain/golf_equipment_maker/golf_clubs
ns:religion.religious_order.monasteries	/religion/monastery/religious_order
ns:ice_hockey.hockey_team.conference	/ice_hockey/hockey_conference/teams
ns:architecture.engineering_firm.projects	/architecture/structure/engineering_firm
ns:wine.wine.region	/wine/wine_region/wines
ns:base.jewlib.research_center.parent_institution	/base/jewlib/parent_institution/jewish_studies_research_units
ns:base.pethealth.pet_disease_or_medical_condition.symptoms	/base/pethealth/symptom/symptom_of
ns:food.ingredient.more_general_ingredient	/food/ingredient/more_specific_ingredient
ns:astronomy.astronomical_discovery.discoverer	/astronomy/astronomer/astronomical_objects_discovered
ns:education.educational_institution.campuses	/education/educational_institution_campus/educational_institution
ns:food.beer.beer_style	/food/beer_style/beers
ns:book.translator.works_translated	/book/translation/translator
ns:business.business_operation.major_customer	/business/customer/supplier
ns:chemistry.chemical_element.isotopes	/chemistry/isotope/isotope_of
ns:base.musiteca.music_teacher.place_of_residence	/base/musiteca/situation/composers_living_here
ns:base.realitytv.reality_tv_contestant.season	/base/realitytv/reality_tv_season/contestants
ns:media_common.quotation.subjects	/media_common/quotation_subject/quotations_about_this_subject
ns:tv.tv_episode_segment.writer	/tv/tv_writer/tv_segments_written
ns:base.mystery.hoax.charlatan_s	/base/mystery/hoaxter/hoax_es
ns:user.alexander.default_domain.supergame.games_contained	/user/alexander/default_domain/subgame/contained_within
ns:amusement_parks.ride.park	/amusement_parks/park/rides
ns:religion.religious_leadership_jurisdiction.size_or_type	/religion/religious_jurisdiction_class/jurisdiction
ns:cvg.computer_videogame.publisher	/cvg/cvg_publisher/games_published
ns:music.group_member.instruments_played	/music/instrument/instrumentalists
ns:base.goldenbooks.little_golden_books.artist	/base/goldenbooks/golden_books_illustrator/golden_books_illustrated
ns:location.administrative_division.country	/location/country/administrative_divisions
ns:amusement_parks.amusement_park_area.parks	/amusement_parks/park/areas
ns:engineering.engine.designer	/engineering/engine_designer/engines_designed
ns:spaceflight.rocket.manufacturer	/spaceflight/rocket_manufacturer/rockets_manufactured
ns:theater.play.orchestrator	/theater/theatrical_orchestrator/plays_orchestrated
ns:freebase.unit_profile.dimension	/measurement_unit/dimension/units
ns:user.narphorium.default_domain.profession.job_titles	/user/narphorium/default_domain/job_title/professions
ns:book.poem.characters	/book/poem_character/appears_in_poems
ns:base.thoroughbredracing.thoroughbred_racehorse.country	/base/thoroughbredracing/thoroughbred_racehorse_origin/horses_from_this_location
ns:base.mathematics1.set.subsets	/base/mathematics1/set/supersets
ns:base.morelaw.lawsuit.defendant	/base/morelaw/defendant/lawsuits
ns:law.court.jurisdiction	/law/court_jurisdiction_area/courts
ns:user.yqbd.ideology.ideology.opponents	/user/yqbd/ideology/ideology/opposes
ns:base.animemanga.anime_manga_character.manga_appearances	/base/animemanga/manga_title/characters
ns:astronomy.galactic_group.galaxy_cluster	/astronomy/galactic_cluster/galaxy_groups
ns:astronomy.telescope.type_of_telescope	/astronomy/telescope_type/telescopes_of_this_type
ns:base.gossipgirlxxx.character.played_by	/m/04sx0s5
ns:base.gossipgirl.character.played_by	/base/gossipgirl/actor/plays
ns:biology.animal_breed.breed_of	/biology/domesticated_animal/breeds
ns:user.narphorium.people.notable_couple.members	/user/narphorium/people/notable_person/part_of_notable_couple
ns:user.micahsaul.five_alarm_food.hot_sauce.manufacturer	/user/micahsaul/five_alarm_food/hot_food_manufacturer/hot_sauce_s
ns:distilled_spirits.distilled_spirit.spirit_type	/distilled_spirits/distilled_spirit_type/spirits
ns:royalty.noble_rank.titles_conferring_this_rank	/royalty/noble_title/noble_rank
ns:projects.project.includes_smaller_projects	/projects/project/part_of_larger_project
ns:base.saturdaynightlive.snl_character.played_by	/base/saturdaynightlive/snl_actor/characters_played
ns:base.obamabase.possible_cabinet_member.cabinet_position	/base/obamabase/cabinet_position/potential_cabinet_members
ns:base.paranormal.person_with_alleged_paranormal_powers.type_of_paranormal_ability	/base/paranormal/type_of_paranormal_ability/person_allegedly_with_this_ability
ns:book.written_work.part_of_series	/book/literary_series/works_in_this_series
ns:base.argumentmaps.original_idea.innovator	/base/argumentmaps/innovator/original_ideas
ns:ice_hockey.hockey_team.coach	/ice_hockey/hockey_coach/current_team
ns:base.mladraft.mla_operator.operates_institutions	/base/mladraft/institution/operated_by
ns:aviation.aircraft_model.variants	/aviation/aircraft_model/parent_aircraft_model
ns:dataworld.provenance.source	/dataworld/information_source/authority
ns:base.folklore.named_mythical_creature.parents	/base/folklore/named_mythical_creature/children
ns:computer.programming_language.parent_language	/computer/programming_language/dialects
ns:medicine.icd_9_cm_classification.includes_classifications	/medicine/icd_9_cm_classification/parent_classification
ns:base.cocktails.cocktail.standard_drinkware	/base/cocktails/cocktail_drinkware/cocktails_with_this_drinkware
ns:base.process.process.input	/base/process/process_state/input_into
ns:user.fairestcat.bandom.musician.band	/user/fairestcat/bandom/band/members
ns:base.motorcycle.engine_type.generic_description	/base/motorcycle/motorcycle_engine_generic_description/engine_type_s
ns:aviation.aircraft_line.models_in_line	/aviation/aircraft_model/part_of_line
ns:user.alexander.philosophy.philosopher.interests	/user/alexander/philosophy/subject/philosophers
ns:people.cause_of_death.includes_causes_of_death	/people/cause_of_death/parent_cause_of_death
ns:user.pak21.default_domain.major_league_sports_team.affiliates	/user/pak21/default_domain/minor_league_sports_team/affiliated_to
ns:fictional_universe.fictional_character.based_on	/fictional_universe/person_in_fiction/representations_in_fiction
ns:base.nascar.nascar_racing_organization.drivers	/base/nascar/nascar_driver/team
ns:amusement_parks.ride.manufacturer	/amusement_parks/ride_manufacturer/rides
ns:music.recording.engineer	/music/engineer/tracks_engineered
ns:base.argumentmaps.object_of_disputed_existence.arguments_that_it_exists	/base/argumentmaps/existential_argument/argues_this_exists
ns:interests.hobbyist.hobbies	/interests/hobby/people_with_this_hobby
ns:base.commonsprototypes.fictional_object_class.subclass	/base/commonsprototypes/fictional_object_class/parent_class
ns:base.animemanga.anime_studio.anime_titles	/base/animemanga/anime_title/anime_studio
ns:amusement_parks.ride.ride_type	/amusement_parks/ride_type/rides
ns:base.casinos.casino.shows	/base/casinos/casino_show/in_casino
ns:book.author.works_edited	/book/written_work/editor
ns:user.mt.default_domain.thinker.influenced_by	/user/mt/default_domain/thinker/influenced
ns:interests.collection_category.parent_category	/interests/collection_category/sub_categories
ns:sports.multi_event_tournament.participating_countries	/sports/sport_country/multi_event_tournaments_participated_in
ns:boats.ship_class.ship_type	/boats/ship_type/ship_class
ns:government.us_president.vice_president	/government/us_vice_president/to_president
ns:architecture.building.building_complex	/architecture/building_complex/buildings_in_complex
ns:language.human_language.countries_spoken_in	/location/country/languages_spoken
ns:architecture.building.building_function	/architecture/building_function/buildings
ns:organization.organization.organization_type	/organization/organization_type/organizations_of_this_type
ns:computer.software_license.versions	/computer/software_license/version_of
ns:conferences.conference.venue	/conferences/conference_venue/conferences
ns:base.metaschema.instance.isa	/base/metaschema/category/instances
ns:broadcast.broadcast.distributor	/broadcast/distributor/distributes
ns:measurement_unit.measurement_system.energy_units	/measurement_unit/energy_unit/measurement_system
ns:computer.computer.includes_models	/computer/computer/parent_model
ns:olympics.olympic_mascot.olympic_games	/olympics/olympic_games/mascot
ns:music.compositional_form.superforms	/music/compositional_form/subforms
ns:opera.opera.librettist	/opera/librettist/libretti
ns:base.locations.continents.planet	/base/locations/planets/continents_within
ns:base.landcover.code_category.contained_by_category	/base/landcover/code_category/contains_categories
ns:base.newsevents.photographic_technique.includes_techniques	/base/newsevents/photographic_technique/included_in_technique
ns:government.government.government_for	/government/governmental_jurisdiction/government
ns:comic_books.comic_book_series.issues	/comic_books/comic_book_issue/part_of_series
ns:spaceflight.space_program.missions	/spaceflight/space_mission/space_program
ns:user.jamslevy.plopquiz.proficiency.proficiency_domain	/user/jamslevy/plopquiz/proficiency_domain/contained_proficiency
ns:language.human_language.dialects	/language/language_dialect/language
ns:base.argumentmaps.moral_support.supporter	/base/argumentmaps/moral_agent/supports_action
ns:astronomy.celestial_object_category.subcategory_of	/astronomy/celestial_object_category/subcategories
ns:food.beer.from_region	/food/beer_country_region/beers_from_here
ns:distilled_spirits.distilled_spirit.bottler	/distilled_spirits/spirit_bottler/spirits_bottled
ns:base.database.database.topic_s	/base/database/database_topic/database_s_for_this_topic
ns:conferences.conference_series.type_of_conference	/conferences/type_of_conference/conferences_of_this_type
ns:base.events.food_festival.food_celebrated	/base/events/food_festival_subject/food_festival
ns:base.peleton.road_bicycle_racing_event.winner	/base/peleton/cyclist/races_won
ns:organization.organization.legal_structure	/business/company_type/companies_of_this_type
ns:broadcast.radio_station_owner.radio_stations	/broadcast/radio_station/owner
ns:royalty.order_of_chivalry.founders	/royalty/chivalric_order_founder/orders_founded
ns:base.americancomedy.comedy_genre.comedians_in_this_genre	/base/americancomedy/comedian/comedy_genres
ns:base.warriors.clan.current_deputy	/base/warriors/clan_cat/currently_deputy_of
ns:broadcast.content.broadcast	/broadcast/broadcast/content
ns:metropolitan_transit.transit_line.stops	/metropolitan_transit/transit_stop/transit_lines
ns:organization.organization.geographic_scope	/organization/organization_scope/organizations_with_this_scope
ns:games.game.derivative_games	/games/game/derived_from
ns:martial_arts.martial_art.category	/martial_arts/martial_art_category/martial_arts
ns:biology.organism.organism_type	/biology/organism_classification/organisms_of_this_type
ns:spaceflight.space_program.sponsor	/spaceflight/space_program_sponsor/space_programs_sponsored
ns:food.wine_style.place_of_origin	/wine/wine_region/wine_styles
ns:religion.religious_organization.member_organizations	/religion/religious_organization/is_member_of
ns:base.nasagcmd.gcmd_keyword1.included_within_keyword	/base/nasagcmd/gcmd_keyword1/includes_keyword_s
ns:computer.programming_language.influenced	/computer/programming_language/influenced_by
ns:book.report_issuing_institution.technical_reports_issued	/book/technical_report/institution
ns:base.linkeddata.linked_data_website.maps_to	/base/linkeddata/linked_data_website/maps_from
ns:sports.boxer.weight_division	/sports/boxing_weight_division/boxers_rated_at_this_weight
ns:user.pvonstackelberg.Futures_Studies.event.included_event	/user/pvonstackelberg/Futures_Studies/event/higher_level_event
ns:user.mt.default_domain.metabolite.chemical_species	/user/mt/default_domain/chemical_species/chemicals
ns:film.film.soundtrack	/music/soundtrack/film
ns:education.educational_institution.sports_teams	/sports/school_sports_team/school
ns:event.disaster.survivors	/event/disaster_survivor/survived_disasters
ns:fictional_universe.fictional_universe.locations	/fictional_universe/fictional_setting/universe
ns:theater.play.genre	/theater/theater_genre/plays_in_this_genre
ns:base.musiteca.music_teacher.composition	/base/musiteca/composition/composer
ns:user.skud.nuclear_weapons.nuclear_test_series.country_responsible	/user/skud/nuclear_weapons/nuclear_power/nuclear_test_series
ns:biology.gene_ontology_group.broader_group	/biology/gene_ontology_group/narrower_group
ns:base.feudalism.feudal_title.associated_lands	/base/feudalism/feudal_location/title
ns:biology.organism_classification_rank.lower_rank	/biology/organism_classification_rank/higher_rank
ns:base.database.database_manager.database_s_managed	/base/database/database/database_manager
ns:base.rosetta.languoid.parent	/base/rosetta/languoid/child
ns:metropolitan_transit.transit_line.service_type	/metropolitan_transit/transit_service_type/transit_lines
ns:visual_art.art_series.subject	/visual_art/art_subject/art_series_on_the_subject
ns:fictional_universe.fictional_universe.created_by	/fictional_universe/fictional_universe_creator/fictional_universes_created
ns:base.fictionaluniverse.fictional_murder_victim.killed_by	/base/fictionaluniverse/fictional_killer/characters_killed
ns:user.jamie.default_domain.yacht_racing.competition.series	/user/jamie/default_domain/yacht_racing/yacht_race/competitions
ns:film.film.written_by	/film/writer/film
ns:base.animemanga.manga_illustrator.manga_illustration_credits	/base/animemanga/manga_title/illustrator
ns:spaceflight.space_mission.launch_site	/spaceflight/rocket_launch_site/missions_launched_here
ns:base.pethealth.pet_disease_or_medical_condition.causes	/base/pethealth/cause/pet_diseases_or_conditions_caused
ns:government.governmental_jurisdiction.government_positions	/government/government_office_or_title/jurisdiction
ns:food.dish.ingredients	/food/ingredient/dishes
ns:base.mladraft.library_system_tenure.library_system	/base/mladraft/library_system/libraries
ns:base.observances.recurring_observance.established_by	/base/observances/observance_founder/recurring_observances
ns:film.film.executive_produced_by	/film/producer/films_executive_produced
ns:base.ecology.food_web_member.eats	/base/ecology/food_web_member/eaten_by
ns:base.ecology.ecosystem.ecosystem_members	/base/ecology/food_web_member/belongs_to_ecosystem_s
ns:sports.sports_official.sport	/sports/sport/officials
ns:cvg.computer_videogame.game_series	/cvg/game_series/games_in_series
ns:user.robert.roman_empire.roman_emperor.dynasty	/user/robert/roman_empire/roman_dynasty/emperors
ns:travel.hotel_brand.owned_by	/travel/hotel_brand_owner/hotel_brands_owned
ns:user.tsegaran.business.trademark_holder.trademark	/user/tsegaran/business/trademark/holder
ns:astronomy.extraterrestrial_location.on_celestial_object	/astronomy/celestial_object/locations
ns:computer.file_format.container_for	/computer/file_format/contained_by
ns:music.artist.supporting_artists	/music/group_member/artists_supported
ns:religion.religion.collective_term_for_adherents	/religion/adherents/religion
ns:medicine.drug.brands	/medicine/drug_brand/active_ingredients
ns:user.jefft0.default_domain.virus_classification.parent_classification	/user/jefft0/default_domain/virus_classification/child_classifications
ns:base.catalog.music_catalog.music_catalog_creator	/base/catalog/music_catalog_creator/music_catalog
ns:base.mathematics1.statement.named_after	/base/mathematics1/mathematician/theorems_with_his_her_name
ns:visual_art.art_subject.artwork_on_the_subject	/visual_art/artwork/art_subject
ns:rail.rail_network.railways	/rail/railway/part_of_network
ns:user.uoa_it.uoa_it.uoa_vendor.provides_application	/user/uoa_it/uoa_it/uoa_application/provided_by
ns:base.locations.countries.planet	/base/locations/planets/countries_within
ns:language.language_family.sub_families	/language/language_family/member_of_language_families
ns:base.litcentral.focal_location.generic_landscape_description	/base/landcover/geographical_feature_category/location_s
ns:base.icons.icon.icon_genre	/base/icons/icon_genre/icons
ns:religion.place_of_worship.religion	/religion/religion/places_of_worship
ns:sports.defunct_sports_team.later_known_as	/sports/sports_team/previously_known_as
ns:base.morelaw.war.peace_treaty	/base/morelaw/peace_treaty/ends_war
ns:business.business_operation.industry	/business/industry/companies
ns:user.alexander.toys.toy_line.includes	/user/alexander/toys/toy_line/included_by
ns:soccer.football_player.position_s	/soccer/football_position/players
ns:military.military_person.service	/military/military_service/military_person
ns:base.filmcameras.camera.camera_series	/base/filmcameras/camera_series/cameras
ns:user.alexander.philosophy.philosopher.schools	/user/alexander/philosophy/school_of_thought/philosophers
ns:bicycles.bicycle_manufacturer.bicycle_models	/bicycles/bicycle_model/manufacturer
ns:broadcast.content.artist	/broadcast/artist/content
ns:base.hauntedplaces.haunted_places.famous_ghosts	/base/hauntedplaces/ghost/haunts
ns:music.composition.includes	/music/composition/part_of
ns:user.robert.mobile_phones.product.brand	/user/robert/mobile_phones/product_brand/products
ns:astronomy.star_system.dwarf_planets	/astronomy/dwarf_planet/star_system
ns:base.crime.crime.victim_s	/base/crime/crime_victim/crime
ns:astronomy.galactic_cluster.galaxy_supercluster	/astronomy/galactic_super_cluster/galaxy_clusters
ns:user.techgnostic.default_domain.tv_series_serial.tv_program	/user/techgnostic/default_domain/tv_program/serials
ns:media_common.netflix_title.netflix_genres	/media_common/netflix_genre/titles
ns:astronomy.star_system.stars	/astronomy/star/star_system
ns:book.literary_series.part_of_series	/book/literary_series/sub_series
ns:sports.sports_team.location	/sports/sports_team_location/teams
ns:user.synedra.didwho.personal_relationship.celebrity	/user/synedra/didwho/person/personal_relationship
ns:military.military_unit.armed_force	/military/armed_force/units
ns:base.crime.crime_victim.crime_type	/base/fight/crime_type/victims_of_this_crime_type
ns:biology.animal_breed.examples	/biology/pedigreed_animal/breed
ns:medicine.disease.symptoms	/medicine/symptom/symptom_of
ns:base.onlineadvertising.ad_network.pricing_models	/base/onlineadvertising/ad_pricing_model/ad_networks
ns:base.jewlib.parent_collection.holder	/base/jewlib/judaica_owner/parent_collections
ns:user.cip22.default_domain.design_pattern.pattern_type	/user/cip22/default_domain/software_design_pattern_type/patterns_of_this_kind
ns:base.argumentmaps.thinker.thinks_this_doesn_t_exist	/base/argumentmaps/object_of_disputed_existence/people_who_think_it_doesn_t_exist
ns:chemistry.chemical_classification.higher_classifications	/chemistry/chemical_classification/lower_classifications
ns:spaceflight.astronaut.space_agency	/spaceflight/space_agency/astronauts
ns:basketball.basketball_team.head_coach	/basketball/basketball_coach/team
ns:music.concert_tour.artist	/music/artist/concert_tours
ns:base.abcbirds.conservation_project.included_within_project	/base/abcbirds/conservation_project/contains_project_s
ns:user.robert3.default_domain.building.architect	/user/robert3/default_domain/architect/buildings
ns:base.musicmanager.managed_artist.managed_by	/base/musicmanager/music_manager/managed
ns:business.product_line.products	/business/consumer_product/product_line
ns:event.disaster.structures_destroyed	/event/disaster_affected_structure/destroyed_by_disaster
ns:business.product_category.product_lines	/business/product_line/category
ns:base.skateboarding.skateboarder.stance	/base/skateboarding/skateboard_stance/skateboarders
ns:location.cn_autonomous_region.designated_minority	/people/chinese_ethnic_group/autonomous_regions
ns:cvg.computer_game_engine.developer	/cvg/computer_game_engine_developer/computer_game_engines_developed
ns:computer.file_format.extended_to	/computer/file_format/extended_from
ns:base.watches.watch_brand.watches_produced	/base/watches/watch_model/brand
ns:base.ancientegypt.pharaoh.successor	/base/ancientegypt/pharaoh/predecessor
ns:language.language_creator.languages_created	/language/conlang/created_by
ns:computer.operating_system.developer	/computer/operating_system_developer/operating_systems_developed
ns:user.digisynddillonm.default_domain.fictional_setting.fictionalization_of	/user/digisynddillonm/default_domain/real_world_location/fictionalized_as
ns:media_common.media_genre.parent_genre	/media_common/media_genre/child_genres
ns:film.film.production_companies	/film/production_company/films
ns:music.multipart_release.components	/music/release_component/package
ns:sports.sports_team.fight_song	/sports/fight_song/sports_team
ns:award.award_category.presenting_organization	/award/award_presenting_organization/award_categories_presented
ns:biology.source_organism.usable_parts	/biology/organism_part/from_organism
ns:book.poem.verse_form	/book/poetic_verse_form/poems_of_this_form
ns:geography.mountain.listings	/geography/mountain_listing/mountains
ns:base.infection.computer_infection.infected_software_opererating_system_s	/base/infection/computer_crime_victim/viral_software_attack
ns:cvg.computer_game_engine.engine_family	/cvg/computer_game_engine_family/engines_in_this_family
ns:comic_books.comic_book_issue.cover_pencils	/comic_books/comic_book_penciler/comic_covers_penciled
ns:user.sprocketonline.economics.legislation.passed_by	/user/sprocketonline/economics/legislative_body/passed_legislation
ns:base.horsefacts.coat_color.causative_locus	/base/horsefacts/coat_locus_effect/coat_colors
ns:measurement_unit.measurement_system.volume_units	/measurement_unit/volume_unit/measurement_system
ns:theater.play.lyricist	/theater/theatrical_lyricist/play_lyrics_written
ns:medicine.disease.notable_people_with_this_condition	/medicine/notable_person_with_medical_condition/condition
ns:film.film.film_collections	/film/film_collection/films_in_collection
ns:base.engineering.tunnel_use.tunnels	/base/engineering/tunnel/tunnel_use
ns:award.ranked_list_compiler.ranked_lists	/award/ranked_list/ranked_by
ns:base.visleg.collaborator.topics_of_interest	/base/visleg/collaboration_topic/collaborators
ns:music.recording.producer	/music/producer/tracks_produced
ns:base.charities.charity.geographic_scope	/base/charities/geographic_scope/charities
ns:people.person.profession	/people/profession/people_with_this_profession
ns:chemistry.chemical_classification.chemicals_of_this_type	/chemistry/chemical_compound/classifications
ns:base.argumentmaps.explanation.explained_thing	/base/argumentmaps/subject_of_curiousity/explanation
ns:base.events.festival_series.type_of_festival	/base/events/type_of_festival/recurring_festivals_of_this_type
ns:base.animemanga.anime_manga_creator.anime_manga_created	/base/animemanga/anime_manga_franchise/anime_manga_creator
ns:computer.operating_system.parent_os	/computer/operating_system/includes_os_versions
ns:base.events.type_of_festival.focus_subject	/base/events/subject_of_festival/festivals_of_this_type
ns:basketball.basketball_conference.divisions	/basketball/basketball_division/conference
ns:comic_books.comic_book_story.script	/comic_books/comic_book_writer/comic_books_written
ns:people.american_indian_group.us_indian_reservations	/location/us_indian_reservation/tribes
ns:user.robert.x2008_presidential_election.campaign.candidate	/user/robert/x2008_presidential_election/candidate/presidential_campaigns
ns:government.government_agency.predecessor_agency	/government/government_agency/successor_agency
ns:base.animemanga.anime_director.anime_directing_credits	/base/animemanga/anime_title/anime_director
ns:music.composition.composer	/music/composer/compositions
ns:base.mosaic.included_broadcaster.country_of_origin	/base/mosaic/mosaic_country/broadcasters
ns:fictional_universe.fictional_organization.parent_organization_in_fiction	/fictional_universe/fictional_organization/sub_organization_in_fiction
ns:book.book_character.appears_in_stories	/book/short_story/characters
ns:digicams.digital_camera.compressed_formats	/digicams/camera_compressed_format/cameras
ns:boats.ship.ship_builder	/boats/ship_builder/ships_built
ns:meteorology.cloud.varieties	/meteorology/cloud/cloud_family
ns:tv.tv_series_episode.writer	/tv/tv_writer/episodes_written
ns:base.americancivilwar.campaign.battle	/base/americancivilwar/battle/campaign
ns:base.ikariam.ikariam_research.category	/base/ikariam/ikariam_research_category/researches
ns:astronomy.asteroid_group.asteroid_group_members	/astronomy/asteroid/member_of_asteroid_group
ns:tv.tv_subject.tv_programs	/tv/tv_program/subjects
ns:education.educational_institution.newspaper	/education/school_newspaper/school
ns:government.political_party.ideology	/government/political_ideology/political_parties
ns:user.micahsaul.five_alarm_food.hot_sauce.sauce_base	/user/micahsaul/five_alarm_food/hot_sauce_base/sauces_with_this_base
ns:computer.computer.manufacturer	/computer/computer_manufacturer_brand/computer_models
ns:amusement_parks.ride.area	/amusement_parks/amusement_park_area/rides
ns:user.tfmorris.default_domain.document.signatories	/user/tfmorris/default_domain/signatory/documents_signed
ns:measurement_unit.dose_equivalence_unit.measurement_system	/measurement_unit/measurement_system/dose_equivalence_units
ns:film.film.film_casting_director	/film/film_casting_director/films_casting_directed
ns:film.film.produced_by	/film/producer/film
ns:theater.theater_production.producer	/theater/theater_producer/plays_produced
ns:base.morelaw.lawsuit.plaintiff	/base/morelaw/plaintiff/lawsuits
ns:base.fairytales.fairy_tale.origin	/base/fairytales/fairy_tale_origin/fairy_tale_from_here
ns:base.arthist.int_zm_nyek.helynev	/base/arthist/helynevek/intezmeny
ns:base.crime.lawyer.law_firm	/base/crime/law_firm/lawyers_in_firm
ns:base.crime.execution.person_executed	/base/crime/executed_person/execution
ns:ice_hockey.hockey_team.division	/ice_hockey/hockey_division/teams
ns:american_football.football_division.conference	/american_football/football_conference/divisions
ns:organization.organization.locations	/business/business_location/parent_company
ns:base.militaryinfiction.location_in_fiction.contains	/base/militaryinfiction/location_in_fiction/contained_by
ns:user.robert.mobile_phones.mobile_phone.operating_system	/user/robert/mobile_phones/mobile_phone_operating_system/mobile_phones_with_this_os
ns:symbols.coat_of_arms.supporter	/symbols/heraldic_supporter/coat_of_arms
ns:base.rivalries.rivalry.rival	/base/rivalries/rival/rivals
ns:measurement_unit.measuring_instrument.dimension_measured	/measurement_unit/dimension/instruments
ns:travel.hotel.operated_by	/travel/hotel_operator/hotels_operated
ns:base.parody.parody.parody_of	/base/parody/parodied_subject/parodies
ns:base.crime.crime.crime_type	/base/fight/crime_type/crimes_of_this_type
ns:base.juiced.user_of_banned_substances.drug_of_choice	/base/juiced/banned_substance/athletes
ns:base.engineering.mine.materials_extracted	/base/engineering/mined_material/mined_at
ns:soccer.football_league.league_system	/soccer/football_league_system/leagues
ns:user.alecf.default_domain.radio_show.hosts	/user/alecf/default_domain/audio_program_host/shows_hosted
ns:base.technologyofdoing.knowledge_worker_practice.agent	/base/technologyofdoing/proposal_agent/practices
ns:user.patrick.default_domain.military_conflict.part_of	/user/patrick/default_domain/military_conflict/battles
ns:dining.cuisine.restaurant	/dining/restaurant/cuisine
ns:military.military_service.military_force	/military/armed_force/personnel
ns:architecture.museum.director	/architecture/museum_director/museum
ns:aviation.aircraft.model	/aviation/aircraft_model/aircraft
ns:education.department.subsidiary_departments	/education/department/department_of
ns:measurement_unit.unit_of_frequency.measurement_system	/measurement_unit/measurement_system/frequency_units
ns:astronomy.astronomical_discovery.discovery_site	/astronomy/astronomical_observatory/discoveries
ns:digicams.digital_camera.supported_storage_types	/digicams/camera_storage_type/compatible_cameras
ns:user.alexander.default_domain.debate.associated_arguments	/user/alexander/default_domain/argument/associated_debate
ns:internet.top_level_domain.registry	/internet/top_level_domain_registry/domains
ns:fictional_universe.fictional_setting.contained_by	/fictional_universe/fictional_setting/contains
ns:measurement_unit.capacitance_unit.measurement_system	/measurement_unit/measurement_system/capacitance_units
ns:music.composition.recorded_as_album	/music/album/compositions
ns:chemistry.chemical_series.elements	/chemistry/chemical_element/chemical_series
ns:base.process.process.parent_more_general_process	/base/process/process/child_process
ns:measurement_unit.magnetic_flux_density_unit.measurement_system	/measurement_unit/measurement_system/magnetic_flux_density_units
ns:base.engineeringdraft.manufactured_component_category.parent_category	/base/engineeringdraft/manufactured_component_category/sub_categories
ns:base.newsevents.photographed_event.photograph_s	/base/newsevents/photograph/photographed_event
ns:metropolitan_transit.transit_line.vehicle_types	/metropolitan_transit/transit_vehicle/transit_lines
ns:theater.play.composer	/theater/theatrical_composer/plays_composed
ns:user.freebass.default_domain.topic_mentioned.mentioned_in	/user/freebass/default_domain/work/mentions
ns:base.bio2rdf.bm.referenced_by	/base/bio2rdf/bm/references
ns:base.snowboard.snowboarder.type_of_snowboarding	/base/snowboard/type_of_snowboarding/snowboarders_of_this_type
ns:visual_art.artwork.art_form	/visual_art/visual_art_form/artworks
ns:astronomy.celestial_object.category	/astronomy/celestial_object_category/objects
ns:base.eventparticipants.participated_event.notable_participants	/base/eventparticipants/known_participants/participated_in
ns:award.award_category.category_of	/award/award/category
ns:geography.geographical_feature.category	/geography/geographical_feature_category/features
ns:base.activism.activism_issue.activist_organizations	/base/activism/organization/area_of_activism
ns:american_football.football_player.position_s	/m/02h7rnw
ns:fictional_universe.fictional_object.owner	/fictional_universe/fictional_character/has_possessed
ns:astronomy.constellation.meteor_showers	/astronomy/meteor_shower/radiant
ns:base.cycleroute.cycle_route_network.cycle_routes	/base/cycleroute/cycle_route/network
ns:base.nationalbridgeinventory.nbibridge.facility_under_bridge	/base/nationalbridgeinventory/bridged_location/bridges
ns:baseball.baseball_player.position_s	/baseball/baseball_position/players
ns:architecture.architect.structures_designed	/architecture/structure/architect
ns:cricket.cricket_coach.current_team	/cricket/cricket_team/coach
ns:base.militaryinfiction.military_unit_size_designation_in_fiction.commanded_by_rank	/base/militaryinfiction/military_rank_in_fiction/commands_unit_size_designations
ns:base.scubadiving.province.contains	/base/scubadiving/ecoregion/province
ns:olympics.olympic_games.venues	/olympics/olympic_venue/olympic_games_used_in
ns:baseball.baseball_team.current_manager	/baseball/baseball_manager/current_team_managed
ns:interests.collection_category.items_in_this_category	/interests/collectable_item/collection_category
ns:base.fires.explosion.cause	/base/fires/explosion_cause/explosion
ns:architecture.architect.architectural_style	/architecture/architectural_style/architects
ns:base.fight.labour_dispute.labour_dispute_type	/base/fight/labour_dispute_type/labour_disputes_of_this_type
ns:base.roses.roses.type_of_rose	/base/roses/type_of_rose/roses_of_this_type
ns:exhibitions.exhibition.produced_by	/exhibitions/exhibition_producer/exhibitions_produced
ns:olympics.olympic_participating_country.olympics_participated_in	/olympics/olympic_games/participating_countries
ns:base.identifier.identifier.issuer	/base/identifier/identifier_issuer/identifier
ns:base.animemanga.manga_author.manga_titles_written	/base/animemanga/manga_title/author
ns:music.concert.venue	/music/performance_venue/concerts
ns:music.recording.artist	/music/artist/track
ns:tv.tv_network.channels	/broadcast/tv_channel/network
ns:computer.software.protocols_used	/computer/internet_protocol/software_used_by
ns:base.thoroughbredracing.thoroughbred_racehorse.damsire	/base/thoroughbredracing/thoroughbred_racehorse/grand_foal_if_horse_is_damsire
ns:base.americancomedy.double_act.straight_man	/base/americancomedy/double_act_straight_man/straight_man_in_double_act
ns:user.duck1123.default_domain.adopted_character.adoptive_parents	/user/duck1123/default_domain/adoptive_character/adopted_childern
ns:food.wine_style.grape_varieties	/wine/grape_variety/wine_styles
ns:people.profession.part_of_professional_field	/people/professional_field/professions_in_this_field
ns:symbols.name_source.namesakes	/symbols/namesake/named_after
ns:base.vancouver.podcaster.podcast	/base/vancouver/podcast/podcaster
ns:user.patrick.default_domain.tagged_topic.tags	/user/patrick/default_domain/tag/tagged_topics
ns:base.satelites.artificial_satellite.orbited_body	/base/satelites/orbited_body/artificial_satellite_s
ns:base.weapons.weapon.parent_weapon_type	/base/weapons/weapon/subtypes
ns:music.composition.form	/music/compositional_form/compositions
ns:computer.file_format.genre	/computer/file_format_genre/file_formats
ns:base.movietheatres.movie_theatre.type_of_movietheatre	/base/movietheatres/type_of_movie_theatre_cinema/movie_theatres_of_this_type
ns:base.computerscience.automaton.language_class_recognized	/base/computerscience/formal_language/automaton
ns:base.argumentmaps.argument.type_of_argument	/base/argumentmaps/type_of_argument/arguments_of_this_type
ns:people.ethnicity.people	/people/person/ethnicity
ns:base.rugby.type_of_rugby.players_of_this_type_of_rugby	/base/rugby/rugby_player/type_of_rugby
ns:base.thoroughbredracing.thoroughbred_racehorse.grandsire	/base/thoroughbredracing/thoroughbred_racehorse/grand_foal_if_horse_is_grandsire
ns:geology.rock_type.parent_rock_type	/geology/rock_type/sub_types
ns:base.usnationalparks.nps_classification.classification	/base/usnationalparks/us_national_park/classification
ns:fictional_universe.fictional_language.where_spoken	/fictional_universe/fictional_setting/languages
ns:base.iceandfire.noble_house.founder	/base/iceandfire/house_founder/founded
ns:media_common.literary_genre.stories_in_this_genre	/book/short_story/genre
ns:education.school_district.schools	/education/school/school_district
ns:film.film.featured_song	/film/film_featured_song/featured_in_film
ns:base.jewlib.research_collection.collection_type	/base/jewlib/collection_type/collection_type_of
ns:base.folklore.location_in_mythology.contains	/base/folklore/location_in_mythology/contained_by
ns:automotive.generation.successor	/automotive/generation/predecessor
ns:internet.website.api	/internet/api/site
ns:fictional_universe.fictional_language.found_in_fictional_universe	/fictional_universe/fictional_universe/languages
ns:base.engineeringdraft.manufactured_component.introduced_by	/base/engineeringdraft/product_designer/product
ns:music.engineer.releases_engineered	/music/release/engineers
ns:base.scenicbyways.scenic_byway_program.authority	/base/scenicbyways/scenic_byway_authority/byway_authority
ns:medicine.medical_specialty.diseases_treated	/medicine/disease/medical_specialties
ns:base.bioventurist.product.developed_by	/base/bioventurist/science_or_technology_company/products
ns:fictional_universe.fictional_calendar_system.used_in_fictional_universes	/fictional_universe/fictional_universe/calendar_systems
ns:base.sameas.consuming_api.vocabulary_used	/base/vocabulary/ontology/uses_vocabulary
ns:automotive.model.generations	/automotive/generation/models
ns:astronomy.galaxy.satellite_galaxies	/astronomy/satellite_galaxy/satellite_of_this_galaxy
ns:music.album.release_type	/music/album_release_type/albums
ns:base.ancientegypt.tomb.owner	/base/ancientegypt/tomb_owner/tomb_owned
ns:base.phytochemical.flavonoid.flavonoid_subclass	/base/phytochemical/flavonoid_subclass/dietary_flavonoid
ns:cvg.video_game_soundtrack.video_game	/cvg/computer_videogame/soundtracks
ns:automotive.company.make_s	/automotive/make/parent_company
ns:user.techgnostic.default_domain.periodical.subject	/user/techgnostic/default_domain/magazine_topic/periodical
ns:base.actsofparliament.acts_of_parliament.amended_by	/base/actsofparliament/acts_of_parliament/amended
ns:base.animemanga.anime_manga_character.anime_appearances	/base/animemanga/anime_title/characters
ns:theater.theater_production.choreographer	/theater/theater_choreographer/plays_choreographed
ns:military.armed_force.sub_divisions	/military/armed_force/sub_division_of
ns:aviation.airport.airport_type	/aviation/airport_type/airports_of_this_type
ns:base.casinos.casino.owner	/base/casinos/casino_owner/casinos_owned
ns:medicine.drug.mechanism_of_action	/medicine/drug_mechanism_of_action/drugs_with_this_mechanism_of_action
ns:fashion.textile.fiber	/fashion/fiber/textiles_made_from_this_fiber
ns:base.americancomedy.tv_show.writers	/base/americancomedy/comedy_writer/wrote_for_tv_shows
ns:base.animemanga.anime_title.animanga_franchise	/base/animemanga/anime_manga_franchise/anime_title
ns:base.propositions.proposition.concerns	/base/propositions/proposition_issue/related
ns:fictional_universe.fictional_character.rank	/fictional_universe/character_rank/characters_of_this_rank
ns:base.satelites.natural_satellite.orbited_body	/base/satelites/orbited_body/natural_satellite_s
ns:government.governmental_body.offices_positions	/government/government_office_or_title/governmental_body_if_any
ns:education.educational_institution.subsidiary_or_constituent_schools	/education/educational_institution/parent_institution
ns:base.whamoworld.wham_o_toy_product_homage.wham_o_product_honored	/base/whamoworld/wham_o_toys/derivative_product
ns:base.landcover.classification_code.classification_system	/base/landcover/classification_system/classification_codes
ns:business.product_category.products	/business/consumer_product/category
ns:metropolitan_transit.transit_system.transit_service_types	/metropolitan_transit/transit_service_type/transit_systems
ns:olympics.olympic_athlete_affiliation.athlete	/olympics/olympic_athlete/country
ns:user.mcstrother.default_domain.artery.origin	/user/mcstrother/default_domain/arterial_origin/origin_to
ns:metropolitan_transit.transit_agency.systems	/metropolitan_transit/transit_system/agency
ns:spaceflight.astronaut.missions	/spaceflight/space_mission/astronauts
ns:base.mediaextended.film_ranch.film_ranch_owner	/base/mediaextended/film_ranch_owner/film_ranch_owned
ns:fictional_universe.fictional_character.gender	/fictional_universe/character_gender/characters_of_this_gender
ns:user.bjoernz.default_domain.podcaster.podcast	/user/bjoernz/default_domain/podcast/host1
ns:location.location.partially_contains	/location/location/partially_containedby
ns:location.country.first_level_divisions	/location/administrative_division/first_level_division_of
ns:base.dinosaur.dinosaur.area_s_of_occurrence	/base/dinosaur/dinosaur_location/dinosaur_s
ns:base.advertisingcharacters.advertising_character.portrayed_by	/base/advertisingcharacters/character_portrayer/appeared_as
ns:base.godparents.godchild.godparents	/base/godparents/godparent/godchildren
ns:user.margit.default_domain.research_project.previous_projects	/user/margit/default_domain/research_project/follow_up_projects
ns:education.educational_institution.mascot	/education/school_mascot/school
ns:base.petbreeds.dog_breed.group	/base/petbreeds/dog_breed_group/dog_breeds
ns:base.computerscience.block_cipher.structure	/base/computerscience/cipher_structure/ciphers
ns:user.micahsaul.advertising.ad_agency.clients	/user/micahsaul/advertising/advertiser/agencies
ns:cvg.computer_game_rating_system.content_descriptors	/cvg/computer_game_content_descriptor/rating_system
ns:music.group_membership.member	/music/group_member/membership
ns:user.joehughes.default_domain.transit_agency.service_areas	/user/joehughes/default_domain/transit_service_area/transit_agencies
ns:base.motorcycle.vehicle_part.motorcycle_section	/base/motorcycle/motorcycle_section/motorcycle_part_s
ns:base.killers.spree_killer.spree_killing_incident	/base/killers/spree_killing/killer_involved
ns:transportation.road.highway_system	/transportation/highway_system/highways
ns:base.pokemon.pok_mon.based_on	/base/pokemon/pokemon_basis/pok_mon_based_on_this
ns:user.agroschim.default_domain.significant_follower.school_tradition	/user/agroschim/default_domain/school_tradition/founder_significant_follower
ns:user.coco.science.concepts_theories.parent_concept	/user/coco/science/concepts_theories/child_concept
ns:cricket.cricket_tournament.events	/cricket/cricket_tournament_event/tournament
ns:film.film.story_by	/film/film_story_contributor/film_story_credits
ns:fictional_universe.fictional_setting.setting_type	/fictional_universe/type_of_fictional_setting/settings
ns:base.eating.diets.avoids_food_type	/base/eating/subject_of_diet/diets_that_avoid_this
ns:location.country.second_level_divisions	/location/administrative_division/second_level_division_of
ns:base.anglican.church.dioceses	/base/anglican/diocese/church
ns:computer.web_browser.layout_engine	/computer/html_layout_engine/browsers
ns:architecture.landscape_architect.landscape_project	/architecture/landscape_project/landscape_architect
ns:conferences.conference_series.subject	/conferences/conference_subject/series_of_conferences_about_this
ns:aviation.airline_alliance.member_airlines	/aviation/airline/alliance
ns:skiing.ski_area.lifts	/skiing/ski_lift/ski_area
ns:fictional_universe.fictional_character.character_created_by	/fictional_universe/fictional_character_creator/fictional_characters_created
ns:book.periodical.subjects	/book/periodical_subject/periodicals
ns:theater.theater_production.director	/theater/theater_director/plays_directed
ns:user.jasso.default_domain.instant_messenger_network.supported_clients	/user/jasso/default_domain/instant_messagers/supported_networks
ns:base.musiteca.performer.place_of_residence	/base/musiteca/situation/performers_living_here
ns:organization.organization.sectors	/organization/organization_sector/organizations_in_this_sector
ns:base.atitdatlas.point_of_interest.region	/base/atitdatlas/region/points_of_interest
ns:sports.sports_equipment.sport_used_for	/sports/sport/related_equipment
ns:library.public_library.library_system	/library/public_library_system/branches
ns:base.infection.computer_infection.typec	/base/infection/computer_infection_type/infectious_software_of_this_type
ns:base.community.local_currency.local_area	/base/community/local_currency_area/currency
ns:base.militaryinfiction.event_in_fiction.location	/base/militaryinfiction/location_in_fiction/events
ns:chemistry.chemical_element.discoverer	/chemistry/element_discoverer/discovered
ns:user.anjackson.default_domain.file_format.versions	/user/anjackson/default_domain/bitstream_encoding/format
ns:base.thoroughbredracing.thoroughbred_racehorse.sire	/base/thoroughbredracing/thoroughbred_racehorse/foal_if_this_horse_is_sire
ns:base.forts.fort.type_of_fort	/base/forts/type_of_fort/forts_of_this_type
ns:religion.religion.founding_figures	/religion/founding_figure/religion_founded
ns:location.location.contains_major_portion_of	/location/location/primarily_containedby
ns:music.guitar.guitarists	/music/guitarist/guitars_played
ns:engineering.signal_modulation_mode.parent_modulation	/engineering/signal_modulation_mode/child_modulation
ns:military.military_person.participated_in_conflicts	/military/military_conflict/military_personnel_involved
ns:base.lookalikes.twins.twin	/base/lookalikes/twin/twin_members
ns:base.peleton.road_bicycle_racing_event.teams_participating_uci_protour	/base/peleton/cycling_team_professional/participated_in_this_race_event
ns:user.thadguidry.default_domain.musical_note_family.octaves	/user/thadguidry/default_domain/musical_note/musical_note_family
ns:base.morelaw.war.ceasefire_s	/base/morelaw/ceasefire/w
ns:base.saints.saint.feast_day	/base/saints/feast_day/saint
ns:base.engineering.canal.part_of_canal_network	/base/engineering/canal_network/canals
ns:military.military_combatant.armed_forces	/military/armed_force/military_combatant
ns:music.composition.subjects	/book/book_subject/musical_compositions_about_this_topic
ns:user.chaswarner.default_domain.file_format.read_by	/user/chaswarner/default_domain/computer_program/reads
ns:book.illustrator.magazine_covers	/book/magazine_issue/cover_artist
ns:film.film.music	/film/music_contributor/film
ns:business.shopping_center.owner	/business/shopping_center_owner/shopping_centers_owned
ns:base.typefaces.typeface.foundry	/base/typefaces/typeface_foundry/typefaces
ns:aviation.airport.terminals	/aviation/airport_terminal/airport
ns:user.jschell.default_domain.famous_speech.orator	/user/jschell/default_domain/orator/speech_given
ns:business.industry.parent_industry	/business/industry/child_industry
ns:protected_sites.protected_site.system	/protected_sites/park_system/member_parks
ns:base.events.type_of_festival.includes_type_of_celebration	/base/events/type_of_festival/included_in_type
ns:base.concepts.concept.developed_by	/base/concepts/concept_developer/concepts_developed
ns:base.locations.cities_and_towns.county	/base/locations/counties_parishes_and_boroughs/cities_within
ns:user.skud.nuclear_weapons.nuclear_test.country_responsible	/user/skud/nuclear_weapons/nuclear_power/nuclear_tests
ns:base.industrystandards.industry_standard.publishing_body	/base/industrystandards/standard_organization/standards
ns:base.unitednations.united_nations_body.agencies	/base/unitednations/united_nations_agency/established_by
ns:base.centreforeresearch.project.software_technology	/base/centreforeresearch/software_technology/used_in_project
ns:medicine.drug.active_moieties	/medicine/drug_ingredient/active_moiety_of_drug
ns:comic_strips.comic_strip_character.comic_strips_appeared_in	/comic_strips/comic_strip/characters
ns:olympics.olympic_event.sport	/olympics/olympic_sport/events
ns:book.author.book_editions_published	/book/book_edition/author_editor
ns:cvg.computer_game_engine.predecessor_engine	/cvg/computer_game_engine/successor_engine
ns:music.artist.tribute_acts	/music/musical_tribute_act/tribute_of
ns:computer.programming_language.developers	/computer/programming_language_developer/programming_languages_developed
ns:people.deceased_person.cause_of_death	/people/cause_of_death/people
ns:medicine.disease.stages	/medicine/disease_stage/stage_of
ns:organization.club.areas_of_interest	/organization/club_interest/clubs
ns:base.fictionaluniverse.fictional_spacecraft_class.feature	/base/fictionaluniverse/fictional_spacecraft_class_feature/spacecraft
ns:common.topic.image	/common/image/appears_in_topic_gallery
ns:cvg.computer_videogame.mods	/cvg/computer_game_mod/game_modded
ns:measurement_unit.measurement_system.weight_units	/measurement_unit/mass_unit/measurement_system
ns:base.charities.charity.field	/base/charities/charitable_field/charitable_organizations
ns:amusement_parks.ride.theme	/amusement_parks/ride_theme/rides
ns:time.event.locations	/location/location/events
ns:book.journal.discipline	/education/field_of_study/journals_in_this_discipline
ns:base.minerals.crystalline_material.polymorph_of	/base/minerals/crystalline_material/polymorphic_forms
ns:royalty.royal_line.preceded_by	/royalty/royal_line/succeeded_by
ns:finance.currency.countries_used	/location/country/currency_used
ns:base.prison.prison.prison_type	/base/prison/prison_type/prisons_of_this_type
ns:metropolitan_transit.transit_system.transit_lines	/metropolitan_transit/transit_line/transit_system
ns:education.department.academics_old	/education/academic/departments_old
ns:base.ports.port_authority.manages	/base/ports/port_of_call/port_authority
ns:measurement_unit.absorbed_dose_unit.measurement_system	/measurement_unit/measurement_system/absorbed_dose_units
ns:fictional_universe.fictional_character.places_lived	/fictional_universe/fictional_setting/characters_that_have_lived_here
ns:base.argumentmaps.proposed_solution.supporters	/base/argumentmaps/thinker/thinks_this_is_effective
ns:spaceflight.rocket_engine.manufactured_by	/spaceflight/rocket_engine_manufacturer/rocket_engines
ns:cvg.computer_videogame.gameplay_modes	/cvg/gameplay_mode/games_with_this_mode
ns:religion.religious_leadership_title.rank_or_role	/religion/religious_leadership_role/religious_titles
ns:law.court.superior_courts	/law/court/inferior_courts
ns:film.film.film_set_decoration_by	/film/film_set_designer/film_sets_designed
ns:event.disaster.victims	/event/disaster_victim/killed_in_disaster
ns:base.conservationaction.collaborator.database_collaboration_s	/base/database/database/collaborator_s1
ns:internet.api.protocols	/internet/protocol/api
ns:base.crime.type_of_law_enforcement_agency.includes_types	/base/crime/type_of_law_enforcement_agency/included_in_types
ns:book.publishing_company.imprints	/book/publishing_company/imprint_of
ns:education.educational_institution.radio_station	/education/student_radio_station/school
ns:comic_books.comic_book_series.publisher	/comic_books/comic_book_publisher/comic_book_series_published
ns:sports.professional_sports_team.owner_s	/sports/sports_team_owner/teams_owned
ns:aviation.aircraft_manufacturer.aircraft_models_made	/aviation/aircraft_model/manufacturer
ns:astronomy.galaxy.constellation	/astronomy/constellation/galaxies_observed_in_constellation
ns:base.fictionaluniverse.fictional_spacecraft_designer.spacecraft_designed	/base/fictionaluniverse/fictional_spacecraft/designed_by
ns:base.warriors.clan_cat.apprentices	/base/warriors/clan_cat/mentors
ns:conferences.conference.focus	/conferences/conference_subject/specific_conferences_about_this
ns:user.robert.roman_empire.roman_emperor.prececessor	/user/robert/roman_empire/roman_emperor/successor
ns:time.day_of_year.calendar_system	/time/calendar/days_of_year
ns:user.robert.us_congress.congressional_caucus.current_house_members	/user/robert/us_congress/us_representative/congressional_caucus_memberships
ns:base.jewlib.judaica_owner.parent_institution	/base/jewlib/parent_institution/judaica_owning_units
ns:finance.currency.countries_formerly_used	/location/country/currency_formerly_used
ns:fictional_universe.fictional_calendar_system.replaced_with	/fictional_universe/fictional_calendar_system/preceded_by
ns:royalty.monarch.kingdom	/royalty/kingdom/rulers
ns:military.military_unit.place_of_origin	/military/military_unit_place_of_origin/military_units
ns:music.album.artist	/music/artist/album
ns:base.skills.skilled_role.performs	/base/skills/skill/performed_by
ns:tv.sequence_of_tv_episode_segments.tv_series	/tv/tv_program/recurring_segments
ns:comic_books.comic_book_story.letters	/comic_books/comic_book_letterer/comic_stories_lettered
ns:tv.tv_series_episode.director	/tv/tv_director/episodes_directed
ns:base.animemanga.anime_manga_franchise.sub_franchise	/base/animemanga/anime_manga_franchise/part_of_franchise
ns:media_common.quotation.spoken_by_character	/fictional_universe/fictional_character/quotations
ns:base.locations.counties_parishes_and_boroughs.coninent	/base/locations/continents/counties_within
ns:medicine.infectious_disease.vector	/medicine/vector_of_disease/disease
ns:baseball.baseball_team.division	/baseball/baseball_division/teams
ns:radio.radio_program.episodes	/radio/radio_program_episode/program
ns:boats.ship.ship_class	/boats/ship_class/ships_in_class
ns:base.horticulture.cultivar.female_parent	/base/horticulture/cultivar_parent/female_parent_of
ns:astronomy.astronomical_discovery.discovery_organization	/astronomy/astronomical_survey_project_organization/celestial_objects_discovered
ns:religion.religion.organizations	/religion/religious_organization/associated_with
ns:fictional_universe.fictional_object.featured_in_fictional_universe	/fictional_universe/fictional_universe/fictional_objects
ns:user.rcheramy.default_domain.hockey_championship.champion	/user/rcheramy/default_domain/hockey_team/championships1
ns:language.language_writing_system.languages	/language/human_language/writing_system
ns:base.biologydev.organism_part.part_of	/base/biologydev/complex_organism/part
ns:user.alexander.philosophy.philosopher.notable_ideas	/user/alexander/philosophy/idea/philosopher
ns:base.schemastaging.scholastic_library.institution	/base/schemastaging/educational_institution_extra/libraries
ns:cvg.computer_videogame.designers	/cvg/cvg_designer/games_designed
ns:spaceflight.space_mission.destination	/spaceflight/mission_destination/missions_sent_here
ns:base.engineeringdraft.manufactured_component.meronyms	/base/engineeringdraft/manufactured_component/holonym
ns:book.magazine.genre	/book/magazine_genre/magazines_in_this_genre
ns:base.banned.banned_person.banned_from	/base/banned/banned_thing/people_banned_from_this_thing
ns:organization.organization.advisors	/business/company_advisor/companies_advised
ns:cvg.computer_videogame.cvg_genre	/cvg/cvg_genre/games
ns:user.jamie.oldwine.winery.varietals	/user/jamie/oldwine/varietal/winery
ns:medicine.infectious_disease.vaccine	/medicine/vaccine/infectious_disease
ns:language.language_writing_system.type_of_writing	/language/language_writing_type/writing_systems
ns:computer.software.software_genre	/computer/software_genre/software_in_genre
ns:base.politicalconventions.political_convention.venues	/base/politicalconventions/convention_venue/presidential_nomination_conventions_hosted
ns:government.governmental_body.component_bodies	/government/governmental_body/body_this_is_a_component_of
ns:digicams.digital_camera.format	/digicams/camera_format/cameras
ns:base.breakfast.breakfast_cereal_brand.manufacturer	/base/breakfast/breakfast_cereal_manufacturer/brands
ns:base.typefaces.typeface.based_on	/base/typefaces/typeface/derived_typefaces
ns:base.americancivilwar.theater.campaigns	/base/americancivilwar/campaign/theater
ns:astronomy.star_system.planetary_system	/astronomy/star_system_body/star_system
ns:computer.software_genre.parent_genre	/computer/software_genre/subgenres
ns:base.newsevents.photograph.photographer	/base/newsevents/photographer/pictures_taken
ns:measurement_unit.unit_of_force.measurement_system	/measurement_unit/measurement_system/force_units
ns:government.government_position_held.jurisdiction_of_office	/government/governmental_jurisdiction/governing_officials
ns:opera.opera_production.producing_company	/opera/opera_company/operas_produced
ns:base.infrastructure.infrastructural_municipality.sewage_treatment_plant	/base/infrastructure/sewage_treatment_plant/serves_location_s
ns:base.webvideo.internet_video.writer	/base/webvideo/internet_video_writer/internet_videos_written
ns:comic_books.comic_book_creator.series_created	/comic_books/comic_book_series/created_by
ns:user.robert.us_congress.congressional_district.current_house_representative	/user/robert/us_congress/us_representative/district
ns:base.architecture2.structure2.damaged_in_event	/base/architecture2/structure_damaging_event/damaged_structure
ns:base.argumentmaps.thing_of_disputed_value.disparagement	/base/argumentmaps/expression_of_disvalue/thing_of_disputed_value
ns:base.undergroundhumanthings.underground_object.underneath	/base/undergroundhumanthings/location_on_top_of_something_buried/underground_object
ns:comic_books.comic_book_story.pencils	/comic_books/comic_book_penciler/comic_books_penciled
ns:location.cn_autonomous_prefecture.designated_minority	/people/chinese_ethnic_group/autonomous_prefectures
ns:base.sanfranciscoscene.san_francisco_draq_queen.drag_events_hosted	/base/sanfranciscoscene/san_francisco_scene_event/drag_queen_hostesses
ns:tv.tv_program.theme_song	/tv/tv_theme_song/theme_song_for
ns:tv.tv_program.program_creator	/tv/tv_program_creator/programs_created
ns:engineering.material.subclass	/engineering/material/parent_material_class
ns:measurement_unit.potential_unit.measurement_system	/measurement_unit/measurement_system/potential_units
ns:comic_books.comic_book_issue.characters_on_cover	/comic_books/comic_book_character/cover_appearances
ns:base.argumentmaps.thinker.thinks_this_will_happen	/base/thefuture/possible_future_event/person_that_thinks_this_will_happen
ns:broadcast.tv_station_owner.tv_stations	/broadcast/tv_station/owner
ns:aviation.airport.focus_city_for	/aviation/airline/focus_cities
ns:base.typefaces.typeface.family	/base/typefaces/typeface_family/typefaces
ns:base.ports.port_of_call.marine_terminals	/base/ports/marine_terminal/at_port_of_call
ns:skiing.ski_area.lodges	/skiing/ski_lodge/ski_area
ns:base.locations.counties_parishes_and_boroughs.state_province	/base/locations/states_and_provences/counties_within
ns:organization.organization.committees	/organization/organization_committee/committee_of
ns:distilled_spirits.distilled_spirit.distillery	/distilled_spirits/distillery/spirits
ns:base.propositions.proposition.against	/base/propositions/proposition_issue/against
ns:food.diet.followers	/food/diet_follower/follows_diet
ns:architecture.structure.architectural_style	/architecture/architectural_style/examples
ns:royalty.monarch.royal_line	/royalty/royal_line/monarchs_from_this_line
ns:base.americancivilwar.battle.military_units_involved_in_this_conflict	/base/americancivilwar/military_unit/conflicts_participated_in
ns:base.banking.investment_scheme.includes	/base/banking/investment_scheme/included_in
ns:award.award_category.disciplines_or_subjects	/award/award_discipline/awards_in_this_discipline
ns:sports.sports_league_season.league	/sports/sports_league/seasons
ns:travel.travel_destination.guidebooks	/travel/guidebook/travel_destinations_covered
ns:user.micahsaul.default_domain.music_festival.occurrence_of_festival	/user/micahsaul/default_domain/recurring_festival/festival_occurrence
ns:music.concert_tour.album_or_release_supporting	/music/album/supporting_tours
ns:fictional_universe.fictional_character.medical_conditions	/fictional_universe/medical_condition_in_fiction/characters_with_this_condition
ns:user.uoa_it.uoa_it.uoa_vendor.provides_technology	/user/uoa_it/uoa_it/uoa_technology/provided_by
ns:base.collectives.collective.focus_or_interest	/base/collectives/collective_focus/collectives
ns:film.film.film_festivals	/film/film_festival_event/films
ns:media_common.quotation.author	/people/person/quotations
ns:physics.particle.interactions	/physics/fundamental_interaction/particles
ns:government.government_agency.jurisdiction	/government/governmental_jurisdiction/agencies
ns:zoos.zoo.exhibits	/zoos/zoo_exhibit/zoo
ns:biology.fossil_specimen.organism	/biology/organism_classification/fossil_specimens
ns:base.pokemon.pok_mon.evolves_from	/base/pokemon/evolves_from/evolves_to
ns:people.ethnicity.included_in_group	/people/ethnicity/includes_groups
ns:base.motorcycle.motorcycle_make.manufacturer	/base/motorcycle/motorcycle_manufacturer/makes
ns:astronomy.asteroid.spectral_type	/astronomy/asteroid_spectral_type/asteroids_of_this_type
ns:book.written_work.subjects	/book/book_subject/works
ns:games.game.genre	/games/game_genre/boardgames
ns:base.folklore.mythology.mythical_creatures	/base/folklore/mythical_creature/mythology
ns:book.school_or_movement.associated_authors	/book/author/school_or_movement
ns:martial_arts.martial_artist.martial_art	/martial_arts/martial_art/well_known_practitioner
ns:law.invention.inventor	/law/inventor/inventions
ns:base.semantics.meaning.up	/base/semantics/meaning/down
ns:base.prison.prison.security_class	/base/prison/prison_security_class/prisons
ns:religion.religion.includes	/religion/religion/is_part_of
ns:base.schemastaging.food_extra.broader	/base/schemastaging/food_extra/narrower
ns:music.arrangement.arrangement_of	/music/composition/arrangements
ns:base.puzzles.puzzle_form.specialization_of	/base/puzzles/puzzle_form/generalization_of
ns:astronomy.trans_neptunian_object.region	/astronomy/trans_neptunian_region/trans_neptunian_objects
ns:award.competition.competitors	/award/competitor/competitions
ns:base.conservationaction.coordinated_program.included_within_program	/base/conservationaction/coordinated_program/includes_program_s
ns:base.weapons.gun.ammunition_used	/base/weapons/ammunition/used_in_guns
ns:architecture.structure.architecture_firm	/architecture/architecture_firm/projects
ns:base.actsofparliament.acts_of_parliament.parliament	/base/actsofparliament/parliaments/acts_passed
ns:base.folklore.mythical_person.mythology	/base/folklore/mythology/mythical_people
ns:automotive.manufacturing_plant.company	/automotive/company/manufacturing_plants
ns:common.topic.subjects	/common/topic/subject_of
ns:base.americancomedy.comedy_group.founders	/base/americancomedy/comedy_group_founder/groups_founded
ns:film.film.edited_by	/film/editor/film
ns:sports.sports_position.sport	/sports/sport/positions
ns:visual_art.art_period_movement.associated_artists	/visual_art/visual_artist/associated_periods_or_movements
ns:film.film.cinematography	/film/cinematographer/film
ns:broadcast.producer.produces	/broadcast/content/producer
ns:time.event.included_in_event	/time/event/includes_event
ns:astronomy.near_earth_object.near_earth_object_classification	/astronomy/near_earth_object_classification/near_earth_objects
ns:language.language_family.languages	/language/human_language/language_family
ns:symbols.coat_of_arms.crest	/symbols/heraldic_crest/coat_of_arms
ns:education.academic.research_areas	/education/field_of_study/academics_in_this_field
ns:user.jeff.stories_to_novels.adapted_story.became_novel	/user/jeff/stories_to_novels/resultant_novel/incorporates_stories
ns:film.film.rating	/film/content_rating/film
ns:medicine.drug.route_of_administration	/medicine/drug_administration_route/administered_drugs
ns:measurement_unit.distance_unit.measurement_system	/measurement_unit/measurement_system/length_units
ns:base.conservationaction.coordinated_program.partner_agency_organization_s	/base/abcbirds/partnership/program_partnership_s
ns:base.qualia.recreational_drug.notable_users	/base/qualia/recreational_drug_user/drug_s
ns:medicine.drug_ingredient.more_general_ingredient	/medicine/drug_ingredient/more_specific_ingredient
